date,code,floor,basic_price,ceiling_price,floor_price,close,open,high,low,average,adjust_close,adjust_open,adjust_high,adjust_low,adjust_average,change,adjust_change,percent_change,volume_match,value_match,volume_reconcile,value_reconcile,total_volume,total_value
11/8/24,E1VFVN30,HOSE,23270,24890,21650,23040,23260,23270,22910,23126,23040,23260,23270,22910,23126,-230,-230,-988.4,182000000,4.2089E+12,200000000,4.5996E+12,382000000,8.8085E+12
11/7/24,E1VFVN30,HOSE,23330,24960,21700,23270,23460,23460,23220,23306,23270,23460,23460,23220,23306,-60,-60,-257.2,80900000,1.88541E+12,100000000,2.3246E+12,180900000,4.21001E+12
11/6/24,E1VFVN30,HOSE,23000,24610,21390,23330,23000,23330,23000,23147,23330,23000,23330,23000,23147,330,330,1434.8,336900000,7.79824E+12,200000000,4.6442E+12,536900000,1.24424E+13
11/5/24,E1VFVN30,HOSE,23000,24610,21390,23000,23030,23050,22990,23012,23000,23030,23050,22990,23012,0,0,0,168900000,3.88665E+12,0,0,168900000,3.88665E+12
11/4/24,E1VFVN30,HOSE,23230,24850,21610,23000,23230,23300,22600,23040,23000,23230,23300,22600,23040,-230,-230,-990.1,285800000,6.58478E+12,0,0,285800000,6.58478E+12
11/1/24,E1VFVN30,HOSE,23430,25070,21790,23230,23350,23380,23140,23286,23230,23350,23380,23140,23286,-200,-200,-853.6,222800000,5.18807E+12,0,0,222800000,5.18807E+12
10/31/24,E1VFVN30,HOSE,23350,24980,21720,23430,23350,23490,23250,23378,23430,23350,23490,23250,23378,80,80,342.6,117400000,2.74457E+12,0,0,117400000,2.74457E+12
10/30/24,E1VFVN30,HOSE,23310,24940,21680,23350,23340,23430,23230,23318,23350,23340,23430,23230,23318,40,40,171.6,355100000,8.28034E+12,1100000000,2.55885E+13,1455100000,3.38688E+13
10/29/24,E1VFVN30,HOSE,23180,24800,21560,23310,23390,23390,23250,23309,23310,23390,23390,23250,23309,130,130,560.8,134800000,3.14205E+12,1800000000,4.1934E+13,1934800000,4.50761E+13
10/28/24,E1VFVN30,HOSE,23310,24940,21680,23180,23310,23360,23130,23170,23180,23310,23360,23130,23170,-130,-130,-557.7,479200000,1.11032E+13,100000000,2.3169E+12,579200000,1.34201E+13
10/25/24,E1VFVN30,HOSE,23290,24920,21660,23310,23400,23400,23160,23238,23310,23400,23400,23160,23238,20,20,85.9,1147500000,2.66658E+13,100000000,2.3194E+12,1247500000,2.89852E+13
10/24/24,E1VFVN30,HOSE,23620,25270,21970,23290,23610,23630,23290,23428,23290,23610,23630,23290,23428,-330,-330,-1397.1,464700000,1.08872E+13,0,0,464700000,1.08872E+13
10/23/24,E1VFVN30,HOSE,23680,25330,22030,23620,23690,23690,23450,23555,23620,23690,23690,23450,23555,-60,-60,-253.4,234100000,5.51418E+12,0,0,234100000,5.51418E+12
10/22/24,E1VFVN30,HOSE,23700,25350,22050,23680,23840,23840,23500,23698,23680,23840,23840,23500,23698,-20,-20,-84.4,314100000,7.44364E+12,0,0,314100000,7.44364E+12
10/21/24,E1VFVN30,HOSE,23930,25600,22260,23700,23930,23930,23700,23793,23700,23930,23930,23700,23793,-230,-230,-961.1,489800000,1.16539E+13,100000000,2.3825E+12,589800000,1.40364E+13
10/18/24,E1VFVN30,HOSE,23780,25440,22120,23930,24000,24000,23800,23918,23930,24000,24000,23800,23918,150,150,630.8,168900000,4.03969E+12,0,0,168900000,4.03969E+12
10/17/24,E1VFVN30,HOSE,23700,25350,22050,23780,23700,24000,23560,23670,23780,23700,24000,23560,23670,80,80,337.6,563100000,1.33283E+13,500000000,1.18375E+13,1063100000,2.51658E+13
10/16/24,E1VFVN30,HOSE,23720,25380,22060,23700,23700,23750,23610,23671,23700,23700,23750,23610,23671,-20,-20,-84.3,276900000,6.55436E+12,700000000,1.65536E+13,976900000,2.3108E+13
10/15/24,E1VFVN30,HOSE,23770,25430,22110,23720,23770,23920,23680,23753,23720,23770,23920,23680,23753,-50,-50,-210.3,337900000,8.02616E+12,0,0,337900000,8.02616E+12
10/14/24,E1VFVN30,HOSE,23830,25490,22170,23770,23850,24000,23770,23926,23770,23850,24000,23770,23926,-60,-60,-251.8,213300000,5.10332E+12,0,0,213300000,5.10332E+12
10/11/24,E1VFVN30,HOSE,23800,25460,22140,23830,23820,23840,23700,23771,23830,23820,23840,23700,23771,30,30,126.1,149800000,3.56085E+12,0,0,149800000,3.56085E+12
10/10/24,E1VFVN30,HOSE,23720,25380,22060,23800,23710,23930,23710,23856,23800,23710,23930,23710,23856,80,80,337.3,124300000,2.96534E+12,400000000,9.5422E+12,524300000,1.25075E+13
10/9/24,E1VFVN30,HOSE,23500,25140,21860,23720,23580,23720,23430,23572,23720,23580,23720,23430,23572,220,220,936.2,302500000,7.1305E+12,0,0,302500000,7.1305E+12
10/8/24,E1VFVN30,HOSE,23410,25040,21780,23500,23410,23530,23310,23386,23500,23410,23530,23310,23386,90,90,384.5,223100000,5.21733E+12,0,0,223100000,5.21733E+12
10/7/24,E1VFVN30,HOSE,23380,25010,21750,23410,23380,23570,23250,23397,23410,23380,23570,23250,23397,30,30,128.3,142800000,3.34113E+12,0,0,142800000,3.34113E+12
10/4/24,E1VFVN30,HOSE,23680,25330,22030,23380,23680,23680,23380,23513,23380,23680,23680,23380,23513,-300,-300,-1266.9,139400000,3.27766E+12,0,0,139400000,3.27766E+12
10/3/24,E1VFVN30,HOSE,23780,25440,22120,23680,23780,23940,23550,23760,23680,23780,23940,23550,23760,-100,-100,-420.5,125400000,2.9795E+12,400000000,9.5498E+12,525400000,1.25293E+13
10/2/24,E1VFVN30,HOSE,23810,25470,22150,23780,23810,23810,23580,23672,23780,23810,23810,23580,23672,-30,-30,-126,188000000,4.45034E+12,0,0,188000000,4.45034E+12
10/1/24,E1VFVN30,HOSE,23650,25300,22000,23810,23700,23960,23700,23864,23810,23700,23960,23700,23864,160,160,676.5,312500000,7.45759E+12,0,0,312500000,7.45759E+12
9/30/24,E1VFVN30,HOSE,23680,25330,22030,23650,23680,23680,23550,23596,23650,23680,23680,23550,23596,-30,-30,-126.7,127600000,3.01079E+12,400000000,9.4451E+12,527600000,1.24559E+13
9/27/24,E1VFVN30,HOSE,23700,25350,22050,23680,23700,23800,23560,23668,23680,23700,23800,23560,23668,-20,-20,-84.4,325400000,7.70145E+12,0,0,325400000,7.70145E+12
9/26/24,E1VFVN30,HOSE,23460,25100,21820,23700,23460,23790,23460,23619,23700,23460,23790,23460,23619,240,240,1023,720700000,1.70223E+13,500000000,1.18387E+13,1220700000,2.8861E+13
9/25/24,E1VFVN30,HOSE,23280,24900,21660,23460,23280,23490,23280,23419,23460,23280,23490,23280,23419,180,180,773.2,1206700000,2.82601E+13,500000000,1.1741E+13,1706700000,4.00011E+13
9/24/24,E1VFVN30,HOSE,23110,24720,21500,23280,23110,23280,23070,23131,23280,23110,23280,23070,23131,170,170,735.6,144400000,3.34015E+12,0,0,144400000,3.34015E+12
9/23/24,E1VFVN30,HOSE,23200,24820,21580,23110,23200,23280,23070,23120,23110,23200,23280,23070,23120,-90,-90,-387.9,570600000,1.31925E+13,0,0,570600000,1.31925E+13
9/20/24,E1VFVN30,HOSE,23000,24610,21390,23200,23020,23300,23020,23236,23200,23020,23300,23020,23236,200,200,869.6,575900000,1.33814E+13,0,0,575900000,1.33814E+13
9/19/24,E1VFVN30,HOSE,22940,24540,21340,23000,22940,23020,22900,22965,23000,22940,23020,22900,22965,60,60,261.6,110100000,2.52843E+12,0,0,110100000,2.52843E+12
9/18/24,E1VFVN30,HOSE,22820,24410,21230,22940,22820,22990,22720,22833,22940,22820,22990,22720,22833,120,120,525.9,171500000,3.91593E+12,100000000,2.2885E+12,271500000,6.20443E+12
9/17/24,E1VFVN30,HOSE,22540,24110,20970,22820,22510,22820,22390,22474,22820,22510,22820,22390,22474,280,280,1242.2,88600000,1.99118E+12,200000000,4.4984E+12,288600000,6.48958E+12
9/16/24,E1VFVN30,HOSE,22610,24190,21030,22540,22620,22650,22400,22565,22540,22620,22650,22400,22565,-70,-70,-309.6,295900000,6.67683E+12,0,0,295900000,6.67683E+12
9/13/24,E1VFVN30,HOSE,22720,24310,21130,22610,22800,22800,22570,22617,22610,22800,22800,22570,22617,-110,-110,-484.2,273900000,6.19485E+12,0,0,273900000,6.19485E+12
9/12/24,E1VFVN30,HOSE,22710,24290,21130,22720,22700,22720,22650,22685,22720,22700,22720,22650,22685,10,10,44,253100000,5.74152E+12,1400000000,3.16935E+13,1653100000,3.7435E+13
9/11/24,E1VFVN30,HOSE,22750,24340,21160,22710,22750,23000,22450,22517,22710,22750,23000,22450,22517,-40,-40,-175.8,252400000,5.68331E+12,0,0,252400000,5.68331E+12
9/10/24,E1VFVN30,HOSE,22850,24440,21260,22750,22850,22920,22580,22718,22750,22850,22920,22580,22718,-100,-100,-437.6,140400000,3.18966E+12,200000000,4.511E+12,340400000,7.70066E+12
9/9/24,E1VFVN30,HOSE,22920,24520,21320,22850,22890,22890,22740,22789,22850,22890,22890,22740,22789,-70,-70,-305.4,307500000,7.00774E+12,300000000,6.8392E+12,607500000,1.38469E+13
9/6/24,E1VFVN30,HOSE,22890,24490,21290,22920,23000,23000,22790,22881,22920,23000,23000,22790,22881,30,30,131.1,417300000,9.54808E+12,200000000,4.562E+12,617300000,1.41101E+13
9/5/24,E1VFVN30,HOSE,22990,24590,21390,22890,22990,23090,22810,23011,22890,22990,23090,22810,23011,-100,-100,-435,313200000,7.20693E+12,0,0,313200000,7.20693E+12
9/4/24,E1VFVN30,HOSE,23270,24890,21650,22990,23260,23260,22850,22912,22990,23260,23260,22850,22912,-280,-280,-1203.3,1813900000,4.15608E+13,1980000000,4.53579E+13,3793900000,8.69187E+13
8/30/24,E1VFVN30,HOSE,23180,24800,21560,23270,23180,23270,23160,23236,23270,23180,23270,23160,23236,90,90,388.3,157400000,3.65737E+12,200000000,4.6338E+12,357400000,8.29117E+12
8/29/24,E1VFVN30,HOSE,23120,24730,21510,23180,23300,23300,23130,23189,23180,23300,23300,23130,23189,60,60,259.5,187200000,4.34101E+12,100000000,2.3211E+12,287200000,6.66211E+12
8/28/24,E1VFVN30,HOSE,23090,24700,21480,23120,23030,23140,23030,23105,23120,23030,23140,23030,23105,30,30,129.9,169000000,3.90465E+12,1660000000,3.83371E+13,1829000000,4.22417E+13
8/27/24,E1VFVN30,HOSE,23050,24660,21440,23090,22950,23140,22950,23048,23090,22950,23140,22950,23048,40,40,173.5,129700000,2.98928E+12,200000000,4.6146E+12,329700000,7.60388E+12
8/26/24,E1VFVN30,HOSE,23070,24680,21460,23050,23050,23140,22500,23041,23050,23050,23140,22500,23041,-20,-20,-86.7,188900000,4.35242E+12,0,0,188900000,4.35242E+12
8/23/24,E1VFVN30,HOSE,23030,24640,21420,23070,23030,23070,22910,22990,23070,23030,23070,22910,22990,40,40,173.7,146000000,3.35649E+12,600000000,1.3758E+13,746000000,1.71145E+13
8/22/24,E1VFVN30,HOSE,22990,24590,21390,23030,22990,23060,22950,23027,23030,22990,23060,22950,23027,40,40,174,393200000,9.05403E+12,0,0,393200000,9.05403E+12
8/21/24,E1VFVN30,HOSE,22790,24380,21200,22990,22890,22990,22650,22806,22990,22890,22990,22650,22806,200,200,877.6,1010700000,2.30496E+13,800000000,1.8214E+13,1810700000,4.12636E+13
8/20/24,E1VFVN30,HOSE,22690,24270,21110,22790,22690,22860,22690,22787,22790,22690,22860,22690,22787,100,100,440.7,763000000,1.73861E+13,700000000,1.5921E+13,1463000000,3.33071E+13
8/19/24,E1VFVN30,HOSE,22580,24160,21000,22690,22580,22710,22560,22631,22690,22580,22710,22560,22631,110,110,487.2,332100000,7.51561E+12,0,0,332100000,7.51561E+12
8/16/24,E1VFVN30,HOSE,22150,23700,20600,22580,22150,22580,22150,22385.70509,22580,22150,22580,22150,22385.70509,430,430,1941.3,931800000,2.0859E+13,20042400,4475734.4,951842400,2.0859E+13
8/15/24,E1VFVN30,HOSE,22250,23800,20700,22150,22300,22300,22080,22123,22150,22300,22300,22080,22123,-100,-100,-449.4,385500000,8.52849E+12,0,0,385500000,8.52849E+12
8/14/24,E1VFVN30,HOSE,22200,23750,20650,22250,22300,22300,22160,22220,22250,22300,22300,22160,22220,50,50,225.2,127400000,2.83086E+12,0,0,127400000,2.83086E+12
8/13/24,E1VFVN30,HOSE,22250,23800,20700,22200,22300,22300,22070,22104,22200,22300,22300,22070,22104,-50,-50,-224.7,159400000,3.5233E+12,0,0,159400000,3.5233E+12
8/12/24,E1VFVN30,HOSE,22200,23750,20650,22250,22200,22260,22020,22082,22250,22200,22260,22020,22082,50,50,225.2,283100000,6.25133E+12,200000000,4.398E+12,483100000,1.06493E+13
8/9/24,E1VFVN30,HOSE,21830,23350,20310,22200,22000,22200,21820,22011,22200,22000,22200,21820,22011,370,370,1694.9,294800000,6.48896E+12,1150000000,2.52825E+13,1444800000,3.17714E+13
8/8/24,E1VFVN30,HOSE,21980,23510,20450,21830,21940,21940,21600,21780,21830,21940,21940,21600,21780,-150,-150,-682.4,299200000,6.51652E+12,1600000000,3.475E+13,1899200000,4.12665E+13
8/7/24,E1VFVN30,HOSE,22000,23540,20460,21980,22090,22090,21770,21866,21980,22090,22090,21770,21866,-20,-20,-90.9,2180200000,4.76716E+13,2750000000,6.00737E+13,4930200000,1.07745E+14
8/6/24,E1VFVN30,HOSE,21720,23240,20200,22000,21720,22000,21550,21773,22000,21720,22000,21550,21773,280,280,1289.1,620900000,1.35187E+13,2300000000,4.98957E+13,2920900000,6.34144E+13
8/5/24,E1VFVN30,HOSE,22320,23880,20760,21720,22300,22320,21370,21718,21720,22300,22320,21370,21718,-600,-600,-2688.2,2472500000,5.36984E+13,4800000000,1.04571E+14,7272500000,1.5827E+14
8/2/24,E1VFVN30,HOSE,22310,23870,20750,22320,22310,22320,21900,22028,22320,22310,22320,21900,22028,10,10,44.8,602900000,1.32806E+13,1100000000,2.42868E+13,1702900000,3.75674E+13
8/1/24,E1VFVN30,HOSE,22750,24340,21160,22310,22750,22750,22150,22391,22310,22750,22750,22150,22391,-440,-440,-1934.1,407500000,9.12429E+12,1200000000,2.679E+13,1607500000,3.59143E+13
7/31/24,E1VFVN30,HOSE,22580,24160,21000,22750,22580,22750,22500,22631,22750,22580,22750,22500,22631,170,170,752.9,75500000,1.70866E+12,0,0,75500000,1.70866E+12
7/30/24,E1VFVN30,HOSE,22500,24070,20930,22580,22500,22580,22360,22440,22580,22500,22580,22360,22440,80,80,355.6,312900000,7.02141E+12,100000000,2.2449E+12,412900000,9.26631E+12
7/29/24,E1VFVN30,HOSE,22420,23980,20860,22500,22420,22570,22420,22502,22500,22420,22570,22420,22502,80,80,356.8,97400000,2.1917E+12,0,0,97400000,2.1917E+12
7/26/24,E1VFVN30,HOSE,22260,23810,20710,22420,22400,22500,22250,22304,22420,22400,22500,22250,22304,160,160,718.8,139100000,3.10247E+12,0,0,139100000,3.10247E+12
7/25/24,E1VFVN30,HOSE,22310,23870,20750,22260,22310,22310,22120,22174,22260,22310,22310,22120,22174,-50,-50,-224.1,731300000,1.62159E+13,1200000000,2.66079E+13,1931300000,4.28238E+13
7/24/24,E1VFVN30,HOSE,22430,24000,20860,22310,22190,22430,22150,22306,22310,22190,22430,22150,22306,-120,-120,-535,280400000,6.25462E+12,1700000000,3.7885E+13,1980400000,4.41396E+13
7/23/24,E1VFVN30,HOSE,22720,24310,21130,22430,22770,22780,22410,22653,22430,22770,22780,22410,22653,-290,-290,-1276.4,434200000,9.83574E+12,400000000,9.039E+12,834200000,1.88747E+13
7/22/24,E1VFVN30,HOSE,22780,24370,21190,22720,22780,22800,22570,22669,22720,22780,22800,22570,22669,-60,-60,-263.4,131200000,2.9741E+12,0,0,131200000,2.9741E+12
7/19/24,E1VFVN30,HOSE,22810,24400,21220,22780,23200,23200,22670,22765,22780,23200,23200,22670,22765,-30,-30,-131.5,864700000,1.96852E+13,200000000,4.5776E+12,1064700000,2.42628E+13
7/18/24,E1VFVN30,HOSE,22720,24310,21130,22810,22840,22840,22560,22696,22810,22840,22840,22560,22696,90,90,396.1,814500000,1.84862E+13,900000000,2.03616E+13,1714500000,3.88478E+13
7/17/24,E1VFVN30,HOSE,22760,24350,21170,22720,22770,23100,22640,22853,22720,22770,23100,22640,22853,-40,-40,-175.7,1328000000,3.03493E+13,800000000,1.83834E+13,2128000000,4.87327E+13
7/16/24,E1VFVN30,HOSE,22750,24340,21160,22760,22750,22870,22710,22777,22760,22750,22870,22710,22777,10,10,44,350200000,7.97637E+12,700000000,1.594E+13,1050200000,2.39164E+13
7/15/24,E1VFVN30,HOSE,22800,24390,21210,22750,22800,22810,22680,22746,22750,22800,22810,22680,22746,-50,-50,-219.3,107100000,2.43609E+12,800000000,1.81508E+13,907100000,2.05869E+13
7/12/24,E1VFVN30,HOSE,22810,24400,21220,22800,22810,22900,22650,22775,22800,22810,22900,22650,22775,-10,-10,-43.8,158900000,3.61893E+12,1800000000,4.10659E+13,1958900000,4.46848E+13
7/11/24,E1VFVN30,HOSE,22870,24470,21270,22810,22990,23000,22810,22859,22810,22990,23000,22810,22859,-60,-60,-262.4,125000000,2.85734E+12,500000000,1.14345E+13,625000000,1.42918E+13
7/10/24,E1VFVN30,HOSE,23010,24620,21400,22870,23010,23080,22860,22969,22870,23010,23080,22860,22969,-140,-140,-608.4,728100000,1.67236E+13,1000000000,2.3018E+13,1728100000,3.97416E+13
7/9/24,E1VFVN30,HOSE,22940,24540,21340,23010,23500,23500,22770,22961,23010,23500,23500,22770,22961,70,70,305.1,1349100000,3.09764E+13,1100000000,2.52178E+13,2449100000,5.61942E+13
7/8/24,E1VFVN30,HOSE,22980,24580,21380,22940,22980,22990,22830,22913,22940,22980,22990,22830,22913,-40,-40,-174.1,167400000,3.83568E+12,1200000000,2.751E+13,1367400000,3.13457E+13
7/5/24,E1VFVN30,HOSE,22870,24470,21270,22980,22870,22980,22700,22878,22980,22870,22980,22700,22878,110,110,481,113400000,2.59439E+12,1400000000,3.19565E+13,1513400000,3.45509E+13
7/4/24,E1VFVN30,HOSE,22810,24400,21220,22870,22810,22890,22750,22826,22870,22810,22890,22750,22826,60,60,263,164300000,3.75033E+12,2000000000,4.56804E+13,2164300000,4.94307E+13
7/3/24,E1VFVN30,HOSE,22600,24180,21020,22810,22610,22840,22610,22733,22810,22610,22840,22610,22733,210,210,929.2,240800000,5.47407E+12,700000000,1.5898E+13,940800000,2.13721E+13
7/2/24,E1VFVN30,HOSE,22650,24230,21070,22600,22640,22700,22410,22559,22600,22640,22700,22410,22559,-50,-50,-220.8,212900000,4.80287E+12,900000000,2.02348E+13,1112900000,2.50377E+13
7/1/24,E1VFVN30,HOSE,22400,23960,20840,22650,22650,22650,22150,22257,22650,22650,22650,22150,22257,250,250,1116.1,229700000,5.11245E+12,100000000,2.2395E+12,329700000,7.35195E+12
6/28/24,E1VFVN30,HOSE,22460,24030,20890,22400,22650,22650,22220,22416,22400,22650,22650,22220,22416,-60,-60,-267.1,358800000,8.043E+12,1000000000,2.24325E+13,1358800000,3.04755E+13
6/27/24,E1VFVN30,HOSE,22460,24030,20890,22460,22700,22700,22360,22412,22460,22700,22700,22360,22412,0,0,0,181000000,4.05656E+12,800000000,1.79644E+13,981000000,2.2021E+13
6/26/24,E1VFVN30,HOSE,22640,24220,21060,22460,22640,22640,22260,22402,22460,22640,22640,22260,22402,-180,-180,-795.1,223600000,5.00906E+12,500000000,1.12174E+13,723600000,1.62265E+13
6/25/24,E1VFVN30,HOSE,22650,24230,21070,22640,22630,22640,22330,22407,22640,22630,22640,22330,22407,-10,-10,-44.2,540500000,1.21107E+13,3100000000,6.95276E+13,3640500000,8.16383E+13
6/24/24,E1VFVN30,HOSE,23040,24650,21430,22650,23040,23040,22490,22679,22650,23040,23040,22490,22679,-390,-390,-1692.7,1286200000,2.91701E+13,3200000000,7.24244E+13,4486200000,1.01595E+14
6/21/24,E1VFVN30,HOSE,23090,24700,21480,23040,23090,23100,22940,23032,23040,23090,23100,22940,23032,-50,-50,-216.5,68400000,1.57542E+12,0,0,68400000,1.57542E+12
6/20/24,E1VFVN30,HOSE,22920,24520,21320,23090,22920,23200,22880,23017,23090,22920,23200,22880,23017,170,170,741.7,1027000000,2.36387E+13,200000000,4.6046E+12,1227000000,2.82433E+13
6/19/24,E1VFVN30,HOSE,22890,24490,21290,22920,22900,23000,22660,22856,22920,22900,23000,22660,22856,30,30,131.1,1503300000,3.43588E+13,2100000000,4.7649E+13,3603300000,8.20078E+13
6/18/24,E1VFVN30,HOSE,22840,24430,21250,22890,22860,22990,22850,22910,22890,22860,22990,22850,22910,50,50,218.9,287500000,6.5867E+12,400000000,9.166E+12,687500000,1.57527E+13
6/17/24,E1VFVN30,HOSE,23150,24770,21530,22840,23140,23140,22790,22883,22840,23140,23140,22790,22883,-310,-310,-1339.1,342600000,7.83981E+12,800000000,1.82614E+13,1142600000,2.61012E+13
6/14/24,E1VFVN30,HOSE,23300,24930,21670,23150,23300,23300,23150,23251,23150,23300,23300,23150,23251,-150,-150,-643.8,961200000,2.23493E+13,700000000,1.62435E+13,1661200000,3.85928E+13
6/13/24,E1VFVN30,HOSE,23120,24730,21510,23300,23200,23300,23130,23253,23300,23200,23300,23130,23253,180,180,778.5,837800000,1.94811E+13,400000000,9.2781E+12,1237800000,2.87592E+13
6/12/24,E1VFVN30,HOSE,22800,24390,21210,23120,22800,23190,22750,23000,23120,22800,23190,22750,23000,320,320,1403.5,610200000,1.40346E+13,0,0,610200000,1.40346E+13
6/11/24,E1VFVN30,HOSE,22820,24410,21230,22800,22840,22900,22700,22767,22800,22840,22900,22700,22767,-20,-20,-87.6,137800000,3.13724E+12,0,0,137800000,3.13724E+12
6/10/24,E1VFVN30,HOSE,22800,24390,21210,22820,22820,22950,22750,22850,22820,22820,22950,22750,22850,20,20,87.7,602500000,1.37668E+13,500000000,1.14301E+13,1102500000,2.51969E+13
6/7/24,E1VFVN30,HOSE,22640,24220,21060,22800,22680,22860,22680,22791,22800,22680,22860,22680,22791,160,160,706.7,388800000,8.86119E+12,2000000000,4.54825E+13,2388800000,5.43437E+13
6/6/24,E1VFVN30,HOSE,22640,24220,21060,22640,22650,22750,22600,22665,22640,22650,22750,22600,22665,0,0,0,504800000,1.14414E+13,450000000,1.02105E+13,954800000,2.16519E+13
6/5/24,E1VFVN30,HOSE,22620,24200,21040,22640,22620,22830,22600,22713,22640,22620,22830,22600,22713,20,20,88.4,1102800000,2.50473E+13,1100000000,2.49618E+13,2202800000,5.00091E+13
6/4/24,E1VFVN30,HOSE,22630,24210,21050,22620,22620,22750,22580,22671,22620,22620,22750,22580,22671,-10,-10,-44.2,696600000,1.57927E+13,1800000000,4.0765E+13,2496600000,5.65577E+13
6/3/24,E1VFVN30,HOSE,22500,24070,20930,22630,22410,22650,22400,22547,22630,22410,22650,22400,22547,130,130,577.8,872300000,1.96676E+13,1000000000,2.2572E+13,1872300000,4.22396E+13
5/31/24,E1VFVN30,HOSE,22240,23790,20690,22500,22210,22500,22090,22241,22500,22210,22500,22090,22241,260,260,1169.1,728100000,1.61937E+13,1700000000,3.78564E+13,2428100000,5.40501E+13
5/30/24,E1VFVN30,HOSE,22350,23910,20790,22240,22330,22350,21960,22041,22240,22330,22350,21960,22041,-110,-110,-492.2,1398200000,3.08174E+13,400000000,8.8721E+12,1798200000,3.96895E+13
5/29/24,E1VFVN30,HOSE,22540,24110,20970,22350,22690,22690,22320,22465,22350,22690,22690,22320,22465,-190,-190,-842.9,1081300000,2.42915E+13,2100000000,4.70237E+13,3181300000,7.13152E+13
5/28/24,E1VFVN30,HOSE,22390,23950,20830,22540,22350,22540,22340,22399,22540,22350,22540,22340,22399,150,150,669.9,445900000,9.98777E+12,600000000,1.34604E+13,1045900000,2.34482E+13
5/27/24,E1VFVN30,HOSE,22500,24070,20930,22390,22500,22560,22200,22313,22390,22500,22560,22200,22313,-110,-110,-488.9,152900000,3.41161E+12,1900000000,4.23778E+13,2052900000,4.57894E+13
5/24/24,E1VFVN30,HOSE,22550,24120,20980,22500,22440,22680,22250,22550,22500,22440,22680,22250,22550,-50,-50,-221.7,1205500000,2.71844E+13,3300000000,7.41539E+13,4505500000,1.01338E+14
5/23/24,E1VFVN30,HOSE,22500,24070,20930,22550,22500,22550,22300,22428,22550,22500,22550,22300,22428,50,50,222.2,840400000,1.88484E+13,1900000000,4.27192E+13,2740400000,6.15676E+13
5/22/24,E1VFVN30,HOSE,22610,24190,21030,22500,22610,22730,22340,22516,22500,22610,22730,22340,22516,-110,-110,-486.5,704300000,1.5858E+13,0,0,704300000,1.5858E+13
5/21/24,E1VFVN30,HOSE,22670,24250,21090,22610,22670,22670,22420,22591,22610,22670,22670,22420,22591,-60,-60,-264.7,327400000,7.39627E+12,500000000,1.12886E+13,827400000,1.86849E+13
5/20/24,E1VFVN30,HOSE,22570,24140,21000,22670,22570,22800,22570,22716,22670,22570,22800,22570,22716,100,100,443.1,275100000,6.24925E+12,4200000000,9.5529E+13,4475100000,1.01778E+14
5/17/24,E1VFVN30,HOSE,22570,24140,21000,22570,22550,22600,22500,22535,22570,22550,22600,22500,22535,0,0,0,552700000,1.24553E+13,0,0,552700000,1.24553E+13
5/16/24,E1VFVN30,HOSE,22200,23750,20650,22570,22300,22600,22300,22473,22570,22300,22600,22300,22473,370,370,1666.7,1269100000,2.85201E+13,100000000,2.2492E+12,1369100000,3.07693E+13
5/15/24,E1VFVN30,HOSE,22090,23630,20550,22200,22090,22320,22090,22238,22200,22090,22320,22090,22238,110,110,498,594800000,1.32269E+13,0,0,594800000,1.32269E+13
5/14/24,E1VFVN30,HOSE,21930,23460,20400,22090,21960,22150,21960,22016,22090,21960,22150,21960,22016,160,160,729.6,293600000,6.46388E+12,200000000,4.4138E+12,493600000,1.08777E+13
5/13/24,E1VFVN30,HOSE,21990,23520,20460,21930,21970,22100,21880,21951,21930,21970,22100,21880,21951,-60,-60,-272.9,228300000,5.01145E+12,0,0,228300000,5.01145E+12
5/10/24,E1VFVN30,HOSE,22090,23630,20550,21990,22090,22120,21890,22005,21990,22090,22120,21890,22005,-100,-100,-452.7,86900000,1.91224E+12,1900000000,4.16491E+13,1986900000,4.35613E+13
5/9/24,E1VFVN30,HOSE,22080,23620,20540,22090,22070,22200,21940,22084,22090,22070,22200,21940,22084,10,10,45.3,121600000,2.68544E+12,0,0,121600000,2.68544E+12
5/8/24,E1VFVN30,HOSE,22080,23620,20540,22080,22080,22080,21840,21986,22080,22080,22080,21840,21986,0,0,0,1562500000,3.43523E+13,3200000000,7.01656E+13,4762500000,1.04518E+14
5/7/24,E1VFVN30,HOSE,21940,23470,20410,22080,21940,22080,21900,21992,22080,21940,22080,21900,21992,140,140,638.1,336300000,7.3959E+12,300000000,6.5981E+12,636300000,1.3994E+13
5/6/24,E1VFVN30,HOSE,21580,23090,20070,21940,21580,21940,21580,21753,21940,21580,21940,21580,21753,360,360,1668.2,216200000,4.70293E+12,0,0,216200000,4.70293E+12
5/3/24,E1VFVN30,HOSE,21550,23050,20050,21580,21560,21700,21540,21567,21580,21560,21700,21540,21567,30,30,139.2,612400000,1.32075E+13,400000000,8.6636E+12,1012400000,2.18711E+13
5/2/24,E1VFVN30,HOSE,21550,23050,20050,21550,21500,21550,21300,21336,21550,21500,21550,21300,21336,0,0,0,508300000,1.08451E+13,0,0,508300000,1.08451E+13
4/26/24,E1VFVN30,HOSE,21300,22790,19810,21550,21280,21550,21070,21376,21550,21280,21550,21070,21376,250,250,1173.7,167500000,3.58053E+12,0,0,167500000,3.58053E+12
4/25/24,E1VFVN30,HOSE,21270,22750,19790,21300,21210,21300,21090,21206,21300,21210,21300,21090,21206,30,30,141,802900000,1.70259E+13,0,0,802900000,1.70259E+13
4/24/24,E1VFVN30,HOSE,20750,22200,19300,21270,20750,21300,20750,21105,21270,20750,21300,20750,21105,520,520,2506,125000000,2.63816E+12,0,0,125000000,2.63816E+12
4/23/24,E1VFVN30,HOSE,20930,22390,19470,20750,20940,20940,20560,20769,20750,20940,20940,20560,20769,-180,-180,-860,701800000,1.4576E+13,0,0,701800000,1.4576E+13
4/22/24,E1VFVN30,HOSE,20670,22110,19230,20930,20700,20930,20700,20811,20930,20700,20930,20700,20811,260,260,1257.9,638200000,1.32813E+13,0,0,638200000,1.32813E+13
4/19/24,E1VFVN30,HOSE,21060,22530,19590,20670,21060,21060,20520,20630,20670,21060,21060,20520,20630,-390,-390,-1851.9,656800000,1.35496E+13,0,0,656800000,1.35496E+13
4/17/24,E1VFVN30,HOSE,21720,23240,20200,21060,21720,21720,20920,21169,21060,21720,21720,20920,21169,-660,-660,-3038.7,1470900000,3.11377E+13,0,0,1470900000,3.11377E+13
4/16/24,E1VFVN30,HOSE,21720,23240,20200,21720,21700,21720,21010,21203,21720,21700,21720,21010,21203,0,0,0,1752200000,3.71514E+13,0,0,1752200000,3.71514E+13
4/15/24,E1VFVN30,HOSE,22100,23640,20560,21720,21900,22170,21340,21824,21720,21900,22170,21340,21824,-380,-380,-1719.5,407000000,8.88248E+12,0,0,407000000,8.88248E+12
4/12/24,E1VFVN30,HOSE,21840,23360,20320,22100,21850,22110,21800,21920,22100,21850,22110,21800,21920,260,260,1190.5,170800000,3.74385E+12,0,0,170800000,3.74385E+12
4/11/24,E1VFVN30,HOSE,21840,23360,20320,21840,21700,21850,21610,21769,21840,21700,21850,21610,21769,0,0,0,798000000,1.7372E+13,0,0,798000000,1.7372E+13
4/10/24,E1VFVN30,HOSE,21880,23410,20350,21840,21880,21970,21790,21917,21840,21880,21970,21790,21917,-40,-40,-182.8,406800000,8.91596E+12,0,0,406800000,8.91596E+12
4/9/24,E1VFVN30,HOSE,21690,23200,20180,21880,21690,21880,21640,21734,21880,21690,21880,21640,21734,190,190,876,119700000,2.60158E+12,0,0,119700000,2.60158E+12
4/8/24,E1VFVN30,HOSE,21810,23330,20290,21690,21810,21810,21550,21630,21690,21810,21810,21550,21630,-120,-120,-550.2,327900000,7.09239E+12,0,0,327900000,7.09239E+12
4/5/24,E1VFVN30,HOSE,21900,23430,20370,21810,21900,21900,21620,21716,21810,21900,21900,21620,21716,-90,-90,-411,317600000,6.89683E+12,0,0,317600000,6.89683E+12
4/4/24,E1VFVN30,HOSE,22180,23730,20630,21900,22180,22180,21870,21965,21900,22180,22180,21870,21965,-280,-280,-1262.4,708700000,1.55668E+13,0,0,708700000,1.55668E+13
4/3/24,E1VFVN30,HOSE,22200,23750,20650,22180,22200,22290,21920,22011,22180,22200,22290,21920,22011,-20,-20,-90.1,2335900000,5.14155E+13,0,0,2335900000,5.14155E+13
4/2/24,E1VFVN30,HOSE,22380,23940,20820,22200,22380,22400,22000,22176,22200,22380,22400,22000,22176,-180,-180,-804.3,7165000000,1.58888E+14,0,0,7165000000,1.58888E+14
4/1/24,E1VFVN30,HOSE,22570,24140,21000,22380,22550,22550,22170,22313,22380,22550,22550,22170,22313,-190,-190,-841.8,456400000,1.01837E+13,0,0,456400000,1.01837E+13
3/29/24,E1VFVN30,HOSE,22430,24000,20860,22570,22430,22570,22330,22431,22570,22430,22570,22330,22431,140,140,624.2,175700000,3.94111E+12,0,0,175700000,3.94111E+12
3/28/24,E1VFVN30,HOSE,22100,23640,20560,22430,22100,22540,22100,22435,22430,22100,22540,22100,22435,330,330,1493.2,1326700000,2.97644E+13,0,0,1326700000,2.97644E+13
3/27/24,E1VFVN30,HOSE,22080,23620,20540,22100,22080,22250,22050,22141,22100,22080,22250,22050,22141,20,20,90.6,101400000,2.24507E+12,0,0,101400000,2.24507E+12
3/26/24,E1VFVN30,HOSE,21940,23470,20410,22080,21940,22200,21880,22084,22080,21940,22200,21880,22084,140,140,638.1,396500000,8.75647E+12,0,0,396500000,8.75647E+12
3/25/24,E1VFVN30,HOSE,22140,23680,20600,21940,22060,22220,21840,22134,21940,22060,22220,21840,22134,-200,-200,-903.3,394500000,8.73194E+12,0,0,394500000,8.73194E+12
3/22/24,E1VFVN30,HOSE,21880,23410,20350,22140,22010,22330,22010,22160,22140,22010,22330,22010,22160,260,260,1188.3,602200000,1.33453E+13,0,0,602200000,1.33453E+13
3/21/24,E1VFVN30,HOSE,21730,23250,20210,21880,21800,22010,21800,21950,21880,21800,22010,21800,21950,150,150,690.3,864600000,1.89822E+13,0,0,864600000,1.89822E+13
3/20/24,E1VFVN30,HOSE,21260,22740,19780,21730,21300,21800,21220,21580,21730,21300,21800,21220,21580,470,470,2210.7,495400000,1.06924E+13,200000000,4.3474E+12,695400000,1.50398E+13
3/19/24,E1VFVN30,HOSE,21400,22890,19910,21260,21300,21370,21150,21290,21260,21300,21370,21150,21290,-140,-140,-654.2,1077100000,2.29311E+13,1500000000,3.19725E+13,2577100000,5.49036E+13
3/18/24,E1VFVN30,HOSE,21750,23270,20230,21400,21750,21750,21000,21220,21400,21750,21750,21000,21220,-350,-350,-1609.2,1028800000,2.18266E+13,500000000,1.06065E+13,1528800000,3.24331E+13
3/15/24,E1VFVN30,HOSE,21800,23320,20280,21750,21800,21820,21400,21620,21750,21800,21820,21400,21620,-50,-50,-229.4,165700000,3.58222E+12,0,0,165700000,3.58222E+12
3/14/24,E1VFVN30,HOSE,21880,23410,20350,21800,21880,21960,21650,21870,21800,21880,21960,21650,21870,-80,-80,-365.6,176000000,3.84946E+12,0,0,176000000,3.84946E+12
3/13/24,E1VFVN30,HOSE,21400,22890,19910,21880,21400,21920,21400,21610,21880,21400,21920,21400,21610,480,480,2243,208300000,4.50228E+12,100000000,2.1888E+12,308300000,6.69108E+12
3/12/24,E1VFVN30,HOSE,21550,23050,20050,21400,21550,21550,21250,21370,21400,21550,21550,21250,21370,-150,-150,-696.1,265000000,5.66369E+12,2100000000,4.48352E+13,2365000000,5.04989E+13
3/11/24,E1VFVN30,HOSE,21690,23200,20180,21550,21690,21690,20180,21430,21550,21690,21690,20180,21430,-140,-140,-645.5,1138600000,2.43955E+13,1600000000,3.44469E+13,2738600000,5.88424E+13
3/8/24,E1VFVN30,HOSE,21980,23510,20450,21690,22030,22080,21640,21850,21690,22030,22080,21640,21850,-290,-290,-1319.4,650100000,1.42026E+13,3400000000,7.40196E+13,4050100000,8.82222E+13
3/7/24,E1VFVN30,HOSE,21910,23440,20380,21980,21940,22050,21880,21950,21980,21940,22050,21880,21950,70,70,319.5,186500000,4.09275E+12,2750000000,6.0209E+13,2936500000,6.43018E+13
3/6/24,E1VFVN30,HOSE,22010,23550,20470,21910,22010,22190,21910,22040,21910,22010,22190,21910,22040,-100,-100,-454.3,143400000,3.16012E+12,600000000,1.31657E+13,743400000,1.63258E+13
3/5/24,E1VFVN30,HOSE,21940,23470,20410,22010,21940,22020,21830,21910,22010,21940,22020,21830,21910,70,70,319.1,284900000,6.24338E+12,20000000,4.3374E+11,304900000,6.67712E+12
3/4/24,E1VFVN30,HOSE,21870,23400,20340,21940,21870,21980,21810,21900,21940,21870,21980,21810,21900,70,70,320.1,313700000,6.86854E+12,1800000000,3.93623E+13,2113700000,4.62308E+13
3/1/24,E1VFVN30,HOSE,21850,23370,20330,21870,21900,21900,21740,21820,21870,21900,21900,21740,21820,20,20,91.5,198800000,4.3379E+12,435000000,9.44585E+12,633800000,1.37837E+13
2/29/24,E1VFVN30,HOSE,21760,23280,20240,21850,21790,22000,21700,21820,21850,21790,22000,21700,21820,90,90,413.6,1324600000,2.8905E+13,3200000000,6.98254E+13,4524600000,9.87304E+13
2/28/24,E1VFVN30,HOSE,21510,23010,20010,21760,21510,21760,21510,21670,21760,21510,21760,21510,21670,250,250,1162.3,1017800000,2.20566E+13,1800000000,3.906E+13,2817800000,6.11166E+13
2/27/24,E1VFVN30,HOSE,21290,22780,19800,21510,21300,21510,21300,21420,21510,21300,21510,21300,21420,220,220,1033.3,808100000,1.73072E+13,3700000000,7.93838E+13,4508100000,9.6691E+13
2/26/24,E1VFVN30,HOSE,21170,22650,19690,21290,21150,21290,21070,21120,21290,21150,21290,21070,21120,120,120,566.8,244800000,5.17031E+12,0,0,244800000,5.17031E+12
2/23/24,E1VFVN30,HOSE,21420,22910,19930,21170,21430,21640,21110,21470,21170,21430,21640,21110,21470,-250,-250,-1167.1,982400000,2.10928E+13,2700000000,5.78329E+13,3682400000,7.89257E+13
2/22/24,E1VFVN30,HOSE,21470,22970,19970,21420,21480,21480,21330,21390,21420,21480,21480,21330,21390,-50,-50,-232.9,234700000,5.02023E+12,750000000,1.60283E+13,984700000,2.10485E+13
2/21/24,E1VFVN30,HOSE,21440,22940,19940,21470,21430,21500,21300,21400,21470,21430,21500,21300,21400,30,30,139.9,482300000,1.03231E+13,1093900000,2.33837E+13,1576200000,3.37068E+13
2/20/24,E1VFVN30,HOSE,21370,22860,19880,21440,21390,21440,21280,21370,21440,21390,21440,21280,21370,70,70,327.6,343700000,7.3461E+12,900000000,1.92449E+13,1243700000,2.6591E+13
2/19/24,E1VFVN30,HOSE,21100,22570,19630,21370,21100,21370,21100,21250,21370,21100,21370,21100,21250,270,270,1279.6,856400000,1.82001E+13,1000000000,2.11186E+13,1856400000,3.93187E+13
2/16/24,E1VFVN30,HOSE,20970,22430,19510,21100,20980,21130,20980,21050,21100,20980,21130,20980,21050,130,130,619.9,743100000,1.56401E+13,200000000,4.2188E+12,943100000,1.98589E+13
2/15/24,E1VFVN30,HOSE,20950,22410,19490,20970,20950,21130,20950,21040,20970,20950,21130,20950,21040,20,20,95.5,697100000,1.46698E+13,400000000,8.4318E+12,1097100000,2.31016E+13
2/7/24,E1VFVN30,HOSE,20670,22110,19230,20950,20700,20950,20690,20840,20950,20700,20950,20690,20840,280,280,1354.6,203200000,4.23497E+12,200000000,4.1852E+12,403200000,8.42017E+12
2/6/24,E1VFVN30,HOSE,20670,22110,19230,20670,20670,20780,20670,20720,20670,20670,20780,20670,20720,0,0,0,106200000,2.20015E+12,100000000,2.0706E+12,206200000,4.27075E+12
2/5/24,E1VFVN30,HOSE,20230,21640,18820,20670,20230,20740,20230,20470,20670,20230,20740,20230,20470,440,440,2175,2098000000,4.29503E+13,800000000,1.64424E+13,2898000000,5.93927E+13
2/2/24,E1VFVN30,HOSE,20290,21710,18870,20230,20310,20340,20200,20230,20230,20310,20340,20200,20230,-60,-60,-295.7,1957500000,3.95937E+13,0,0,1957500000,3.95937E+13
2/1/24,E1VFVN30,HOSE,20190,21600,18780,20290,20110,20290,20100,20200,20290,20110,20290,20100,20200,100,100,495.3,1344500000,2.71562E+13,400000000,8.082E+12,1744500000,3.52382E+13
1/31/24,E1VFVN30,HOSE,20390,21810,18970,20190,20390,20420,20110,20280,20190,20390,20420,20110,20280,-200,-200,-980.9,308600000,6.25987E+12,300000000,6.0913E+12,608600000,1.23512E+13
1/30/24,E1VFVN30,HOSE,20360,21780,18940,20390,20350,20410,20340,20360,20390,20350,20410,20340,20360,30,30,147.3,224100000,4.56308E+12,0,0,224100000,4.56308E+12
1/29/24,E1VFVN30,HOSE,20400,21820,18980,20360,20400,20470,20180,20410,20360,20400,20470,20180,20410,-40,-40,-196.1,130600000,2.6656E+12,0,0,130600000,2.6656E+12
1/26/24,E1VFVN30,HOSE,20300,21720,18880,20400,20300,20460,20300,20400,20400,20300,20460,20300,20400,100,100,492.6,47500000,9.6895E+11,0,0,47500000,9.6895E+11
1/25/24,E1VFVN30,HOSE,20360,21780,18940,20300,20360,20390,20290,20320,20300,20360,20390,20290,20320,-60,-60,-294.7,304700000,6.19223E+12,0,0,304700000,6.19223E+12
1/24/24,E1VFVN30,HOSE,20440,21870,19010,20360,20440,20490,20350,20460,20360,20440,20490,20350,20460,-80,-80,-391.4,136600000,2.7946E+12,100000000,2.0388E+12,236600000,4.8334E+12
1/23/24,E1VFVN30,HOSE,20520,21950,19090,20440,20520,20560,20400,20460,20440,20520,20560,20400,20460,-80,-80,-389.9,89400000,1.82917E+12,2000000000,4.0884E+13,2089400000,4.27132E+13
1/22/24,E1VFVN30,HOSE,20370,21790,18950,20520,20410,20600,20400,20440,20520,20410,20600,20400,20440,150,150,736.4,699100000,1.42888E+13,0,0,699100000,1.42888E+13
1/19/24,E1VFVN30,HOSE,20230,21640,18820,20370,20380,20450,20330,20400,20370,20380,20450,20330,20400,140,140,692,143200000,2.92175E+12,0,0,143200000,2.92175E+12
1/18/24,E1VFVN30,HOSE,20120,21520,18720,20230,20120,20240,20120,20190,20230,20120,20240,20120,20190,110,110,546.7,144100000,2.90962E+12,200000000,4.0307E+12,344100000,6.94032E+12
1/17/24,E1VFVN30,HOSE,20170,21580,18760,20120,20070,20320,20070,20190,20120,20070,20320,20070,20190,-50,-50,-247.9,91100000,1.8392E+12,800000000,1.61829E+13,891100000,1.80221E+13
1/16/24,E1VFVN30,HOSE,20070,21470,18670,20170,20050,20170,19950,20040,20170,20050,20170,19950,20040,100,100,498.3,462600000,9.26867E+12,0,0,462600000,9.26867E+12
1/15/24,E1VFVN30,HOSE,20100,21500,18700,20070,20110,20300,20050,20140,20070,20110,20300,20050,20140,-30,-30,-149.3,153400000,3.09017E+12,0,0,153400000,3.09017E+12
1/12/24,E1VFVN30,HOSE,20050,21450,18650,20100,19990,20140,19850,20050,20100,19990,20140,19850,20050,50,50,249.4,188300000,3.77483E+12,300000000,5.9967E+12,488300000,9.77153E+12
1/11/24,E1VFVN30,HOSE,20040,21440,18640,20050,20140,21000,20020,20150,20050,20140,21000,20020,20150,10,10,49.9,720400000,1.45131E+13,100000000,2.0017E+12,820400000,1.65148E+13
1/10/24,E1VFVN30,HOSE,20040,21440,18640,20040,20040,20160,19990,20040,20040,20040,20160,19990,20040,0,0,0,191900000,3.84599E+12,0,0,191900000,3.84599E+12
1/9/24,E1VFVN30,HOSE,20080,21480,18680,20040,19860,20100,19860,20000,20040,19860,20100,19860,20000,-40,-40,-199.2,54300000,1.08587E+12,0,0,54300000,1.08587E+12
1/8/24,E1VFVN30,HOSE,20030,21430,18630,20080,20050,20190,19900,20060,20080,20050,20190,19900,20060,50,50,249.6,840300000,1.68548E+13,100000000,1.9944E+12,940300000,1.88492E+13
1/5/24,E1VFVN30,HOSE,19950,21340,18560,20030,20000,20030,19900,19980,20030,20000,20030,19900,19980,80,80,401,324000000,6.47253E+12,1000000000,2.00164E+13,1324000000,2.64889E+13
1/4/24,E1VFVN30,HOSE,19690,21060,18320,19950,19690,20130,19690,19960,19950,19690,20130,19690,19960,260,260,1320.5,723900000,1.4448E+13,200000000,3.9632E+12,923900000,1.84112E+13
1/3/24,E1VFVN30,HOSE,19530,20890,18170,19690,19380,19690,19380,19570,19690,19380,19690,19380,19570,160,160,819.3,455000000,8.90362E+12,500000000,9.7658E+12,955000000,1.86694E+13
1/2/24,E1VFVN30,HOSE,19430,20790,18070,19530,19510,19680,19500,19600,19530,19510,19680,19500,19600,100,100,514.7,568300000,1.11383E+13,300000000,5.8611E+12,868300000,1.69994E+13
12/29/23,E1VFVN30,HOSE,19430,20790,18070,19430,19440,19630,19430,19570,19430,19440,19630,19430,19570,0,0,0,2266600000,4.43547E+13,0,0,2266600000,4.43547E+13
12/28/23,E1VFVN30,HOSE,19270,20610,17930,19430,19160,19530,19160,19410,19430,19160,19530,19160,19410,160,160,830.3,370400000,7.1909E+12,300000000,5.8426E+12,670400000,1.30335E+13
12/27/23,E1VFVN30,HOSE,19240,20580,17900,19270,19250,19350,19240,19300,19270,19250,19350,19240,19300,30,30,155.9,217900000,4.20477E+12,400000000,7.7174E+12,617900000,1.19222E+13
12/26/23,E1VFVN30,HOSE,19200,20540,17860,19240,19200,19260,19160,19210,19240,19200,19260,19160,19210,40,40,208.3,146200000,2.80894E+12,400000000,7.6892E+12,546200000,1.04981E+13
12/25/23,E1VFVN30,HOSE,18950,20270,17630,19200,18950,19200,18950,19150,19200,18950,19200,18950,19150,250,250,1319.3,642600000,1.23072E+13,700000000,1.32685E+13,1342600000,2.55757E+13
12/22/23,E1VFVN30,HOSE,18950,20270,17630,18950,19000,19000,18850,18900,18950,19000,19000,18850,18900,0,0,0,239100000,4.51906E+12,500000000,9.4659E+12,739100000,1.3985E+13
12/21/23,E1VFVN30,HOSE,18920,20240,17600,18950,18930,18950,18800,18840,18950,18930,18950,18800,18840,30,30,158.6,1123800000,2.11736E+13,600000000,1.13328E+13,1723800000,3.25064E+13
12/20/23,E1VFVN30,HOSE,18840,20150,17530,18920,18990,18990,18790,18830,18920,18990,18990,18790,18830,80,80,424.6,204900000,3.85814E+12,1650000000,2.96792E+13,1854900000,3.35373E+13
12/19/23,E1VFVN30,HOSE,18770,20080,17460,18840,18770,18840,18570,18650,18840,18770,18840,18570,18650,70,70,372.9,366300000,6.83252E+12,100000000,1.8759E+12,466300000,8.70842E+12
12/18/23,E1VFVN30,HOSE,19000,20330,17670,18770,19040,19040,18730,18780,18770,19040,19040,18730,18780,-230,-230,-1210.5,611300000,1.14801E+13,1450000000,2.703E+13,2061300000,3.85101E+13
12/15/23,E1VFVN30,HOSE,19080,20410,17750,19000,19030,19090,18960,19010,19000,19030,19090,18960,19010,-80,-80,-419.3,186900000,3.55373E+12,400000000,7.6078E+12,586900000,1.11615E+13
12/14/23,E1VFVN30,HOSE,19100,20430,17770,19080,19260,19260,19050,19140,19080,19260,19260,19050,19140,-20,-20,-104.7,77300000,1.47924E+12,1237000000,2.23444E+13,1314300000,2.38236E+13
12/13/23,E1VFVN30,HOSE,19300,20650,17950,19100,19300,19360,19100,19240,19100,19300,19360,19100,19240,-200,-200,-1036.3,240300000,4.62311E+12,0,0,240300000,4.62311E+12
12/12/23,E1VFVN30,HOSE,19290,20640,17940,19300,19240,19340,19200,19240,19300,19240,19340,19200,19240,10,10,51.8,297100000,5.71744E+12,1337000000,2.4135E+13,1634100000,2.98524E+13
12/11/23,E1VFVN30,HOSE,19230,20570,17890,19290,19250,19320,19190,19240,19290,19250,19320,19190,19240,60,60,312,102700000,1.9763E+12,0,0,102700000,1.9763E+12
12/8/23,E1VFVN30,HOSE,19210,20550,17870,19230,19190,19270,19140,19210,19230,19190,19270,19140,19210,20,20,104.1,301500000,5.79265E+12,0,0,301500000,5.79265E+12
12/7/23,E1VFVN30,HOSE,19070,20400,17740,19210,19080,19230,18920,19050,19210,19080,19230,18920,19050,140,140,734.1,739800000,1.40965E+13,1050000000,2.0046E+13,1789800000,3.41425E+13
12/6/23,E1VFVN30,HOSE,18960,20280,17640,19070,18960,19090,18960,19030,19070,18960,19090,18960,19030,110,110,580.2,347800000,6.61692E+12,300000000,5.73E+12,647800000,1.23469E+13
12/5/23,E1VFVN30,HOSE,19200,20540,17860,18960,19150,19150,18950,19030,18960,19150,19150,18950,19030,-240,-240,-1250,143400000,2.72901E+12,200000000,3.8075E+12,343400000,6.53651E+12
12/4/23,E1VFVN30,HOSE,18780,20090,17470,19200,18830,19200,18830,19030,19200,18830,19200,18830,19030,420,420,2236.4,120500000,2.29334E+12,600000000,1.13875E+13,720500000,1.36808E+13
12/1/23,E1VFVN30,HOSE,18850,20160,17540,18780,18860,18890,18600,18730,18780,18860,18890,18600,18730,-70,-70,-371.4,500300000,9.36942E+12,100000000,1.8763E+12,600300000,1.12457E+13
11/30/23,E1VFVN30,HOSE,18890,20210,17570,18850,18900,18950,18720,18860,18850,18900,18950,18720,18860,-40,-40,-211.8,432300000,8.15197E+12,1200000000,2.26444E+13,1632300000,3.07964E+13
11/29/23,E1VFVN30,HOSE,18750,20060,17440,18890,18770,18980,18770,18880,18890,18770,18980,18770,18880,140,140,746.7,117700000,2.2218E+12,0,0,117700000,2.2218E+12
11/28/23,E1VFVN30,HOSE,18700,20000,17400,18750,18550,18750,18450,18540,18750,18550,18750,18450,18540,50,50,267.4,320300000,5.93746E+12,936400000,1.73881E+13,1256700000,2.33256E+13
11/27/23,E1VFVN30,HOSE,18680,19980,17380,18700,18700,18740,18600,18710,18700,18700,18740,18600,18710,20,20,107.1,472000000,8.82909E+12,200000000,3.7288E+12,672000000,1.25579E+13
11/24/23,E1VFVN30,HOSE,18800,20110,17490,18680,18800,18800,18450,18610,18680,18800,18800,18450,18610,-120,-120,-638.3,538600000,1.00258E+13,200000000,3.7137E+12,738600000,1.37395E+13
11/23/23,E1VFVN30,HOSE,19120,20450,17790,18800,19300,19300,18800,19040,18800,19300,19300,18800,19040,-320,-320,-1673.6,87000000,1.65628E+12,0,0,87000000,1.65628E+12
11/22/23,E1VFVN30,HOSE,19100,20430,17770,19120,19200,19200,18930,19040,19120,19200,19200,18930,19040,20,20,104.7,338300000,6.44046E+12,200000000,3.7954E+12,538300000,1.02359E+13
11/21/23,E1VFVN30,HOSE,19080,20410,17750,19100,19180,19260,19000,19110,19100,19180,19260,19000,19110,20,20,104.8,224400000,4.2887E+12,0,0,224400000,4.2887E+12
11/20/23,E1VFVN30,HOSE,19120,20450,17790,19080,19000,19300,18750,19070,19080,19000,19300,18750,19070,-40,-40,-209.2,1134900000,2.16459E+13,770000000,1.47505E+13,1904900000,3.63964E+13
11/17/23,E1VFVN30,HOSE,19480,20840,18120,19120,19550,19600,18950,19330,19120,19550,19600,18950,19330,-360,-360,-1848,413300000,7.98778E+12,600000000,1.16372E+13,1013300000,1.9625E+13
11/16/23,E1VFVN30,HOSE,19560,20920,18200,19480,19560,19560,19380,19460,19480,19560,19560,19380,19460,-80,-80,-409,63500000,1.23562E+12,0,0,63500000,1.23562E+12
11/15/23,E1VFVN30,HOSE,19300,20650,17950,19560,19520,19770,19520,19660,19560,19520,19770,19520,19660,260,260,1347.2,488600000,9.60686E+12,0,0,488600000,9.60686E+12
11/14/23,E1VFVN30,HOSE,19050,20380,17720,19300,19300,19320,19150,19210,19300,19300,19320,19150,19210,250,250,1312.3,238700000,4.58651E+12,200000000,3.8554E+12,438700000,8.44191E+12
11/13/23,E1VFVN30,HOSE,19050,20380,17720,19050,19060,19240,18960,19220,19050,19060,19240,18960,19220,0,0,0,644400000,1.2387E+13,100000000,1.8998E+12,744400000,1.42868E+13
11/10/23,E1VFVN30,HOSE,19410,20760,18060,19050,19280,19400,19050,19180,19050,19280,19400,19050,19180,-360,-360,-1854.7,2083600000,3.99692E+13,150000000,2.87675E+12,2233600000,4.28459E+13
11/9/23,E1VFVN30,HOSE,19400,20750,18050,19410,19410,19610,19400,19470,19410,19410,19610,19400,19470,10,10,51.5,345000000,6.71619E+12,1150000000,2.22264E+13,1495000000,2.89426E+13
11/8/23,E1VFVN30,HOSE,18880,20200,17560,19400,18960,19400,18700,19210,19400,18960,19400,18700,19210,520,520,2754.2,272200000,5.22872E+12,6000000000,1.16084E+14,6272200000,1.21313E+14
11/7/23,E1VFVN30,HOSE,19050,20380,17720,18880,19000,19000,18800,18890,18880,19000,19000,18800,18890,-170,-170,-892.4,99500000,1.87934E+12,350000000,6.58525E+12,449500000,8.46459E+12
11/6/23,E1VFVN30,HOSE,18830,20140,17520,19050,18830,19050,18830,18940,19050,18830,19050,18830,18940,220,220,1168.3,438900000,8.3117E+12,1400000000,2.63897E+13,1838900000,3.47014E+13
11/3/23,E1VFVN30,HOSE,18660,19960,17360,18830,18890,18890,18650,18720,18830,18890,18890,18650,18720,170,170,911,215400000,4.03299E+12,1800000000,3.36497E+13,2015400000,3.76827E+13
11/2/23,E1VFVN30,HOSE,18300,19580,17020,18660,18400,18660,18180,18360,18660,18400,18660,18180,18360,360,360,1967.2,130800000,2.40141E+12,600000000,1.1076E+13,730800000,1.34774E+13
11/1/23,E1VFVN30,HOSE,18300,19580,17020,18300,18280,18300,17820,17950,18300,18280,18300,17820,17950,0,0,0,299200000,5.36968E+12,2300000000,4.11993E+13,2599200000,4.65689E+13
10/31/23,E1VFVN30,HOSE,18320,19600,17040,18300,18320,18320,17800,18020,18300,18320,18320,17800,18020,-20,-20,-109.2,328500000,5.9207E+12,680000000,1.22033E+13,1008500000,1.8124E+13
10/30/23,E1VFVN30,HOSE,18320,19600,17040,18320,18320,18440,18140,18250,18320,18320,18440,18140,18250,0,0,0,331900000,6.05652E+12,1090000000,1.98667E+13,1421900000,2.59232E+13
10/27/23,E1VFVN30,HOSE,18410,19690,17130,18320,18450,18500,18090,18270,18320,18450,18500,18090,18270,-90,-90,-488.9,690800000,1.26183E+13,450000000,8.196E+12,1140800000,2.08143E+13
10/26/23,E1VFVN30,HOSE,19100,20430,17770,18410,19100,19100,18180,18440,18410,19100,19100,18180,18440,-690,-690,-3612.6,668600000,1.23292E+13,490000000,9.01528E+12,1158600000,2.13445E+13
10/25/23,E1VFVN30,HOSE,19020,20350,17690,19100,19130,19320,19100,19220,19100,19130,19320,19100,19220,80,80,420.6,122900000,2.36197E+12,500000000,9.6525E+12,622900000,1.20145E+13
10/24/23,E1VFVN30,HOSE,19170,20510,17830,19020,19210,19280,18900,19060,19020,19210,19280,18900,19060,-150,-150,-782.5,2156500000,4.10941E+13,300000000,5.741E+12,2456500000,4.68351E+13
10/23/23,E1VFVN30,HOSE,19410,20760,18060,19170,19470,19470,18920,19110,19170,19470,19470,18920,19110,-240,-240,-1236.5,463000000,8.84847E+12,200000000,3.787E+12,663000000,1.26355E+13
10/20/23,E1VFVN30,HOSE,19680,21050,18310,19410,19560,19650,18900,19100,19410,19560,19650,18900,19100,-270,-270,-1372,242200000,4.62572E+12,8350000000,1.5803E+14,8592200000,1.62655E+14
10/19/23,E1VFVN30,HOSE,19490,20850,18130,19680,19490,19680,19100,19170,19680,19490,19680,19100,19170,190,190,974.9,917700000,1.75965E+13,500000000,9.6631E+12,1417700000,2.72596E+13
10/18/23,E1VFVN30,HOSE,19800,21180,18420,19490,19800,19800,19100,19490,19490,19800,19800,19100,19490,-310,-310,-1565.7,533100000,1.03891E+13,1800000000,3.46582E+13,2333100000,4.50473E+13
10/17/23,E1VFVN30,HOSE,19750,21130,18370,19800,20000,20080,19790,19900,19800,20000,20080,19790,19900,50,50,253.2,497500000,9.89796E+12,0,0,497500000,9.89796E+12
10/16/23,E1VFVN30,HOSE,20060,21460,18660,19750,20060,20060,19750,19840,19750,20060,20060,19750,19840,-310,-310,-1545.4,534900000,1.0612E+13,1920000000,3.81753E+13,2454900000,4.87873E+13
10/13/23,E1VFVN30,HOSE,20000,21400,18600,20060,19980,20060,19780,19860,20060,19980,20060,19780,19860,60,60,300,1605900000,3.18912E+13,1200000000,2.3886E+13,2805900000,5.57772E+13
10/12/23,E1VFVN30,HOSE,19950,21340,18560,20000,19960,20110,19950,20030,20000,19960,20110,19950,20030,50,50,250.6,605900000,1.21352E+13,400000000,8.0228E+12,1005900000,2.0158E+13
10/11/23,E1VFVN30,HOSE,19930,21320,18540,19950,20000,20000,19800,19920,19950,20000,20000,19800,19920,20,20,100.4,522800000,1.04143E+13,140000000,2.80896E+12,662800000,1.32232E+13
10/10/23,E1VFVN30,HOSE,19750,21130,18370,19930,19780,19990,19780,19950,19930,19780,19990,19780,19950,180,180,911.4,89800000,1.79183E+12,40000000,7.9904E+11,129800000,2.59087E+12
10/9/23,E1VFVN30,HOSE,19650,21020,18280,19750,19690,19750,19580,19650,19750,19690,19750,19580,19650,100,100,508.9,175000000,3.43873E+12,200000000,3.9339E+12,375000000,7.37263E+12
10/6/23,E1VFVN30,HOSE,19490,20850,18130,19650,19500,19660,19300,19410,19650,19500,19660,19300,19410,160,160,820.9,240400000,4.66615E+12,0,0,240400000,4.66615E+12
10/5/23,E1VFVN30,HOSE,19680,21050,18310,19490,19680,19700,19400,19550,19490,19680,19700,19400,19550,-190,-190,-965.4,818200000,1.59941E+13,500000000,9.7396E+12,1318200000,2.57337E+13
10/4/23,E1VFVN30,HOSE,19550,20910,18190,19680,19550,19820,19300,19500,19680,19550,19820,19300,19500,130,130,665,195900000,3.82001E+12,400000000,7.8082E+12,595900000,1.16282E+13
10/3/23,E1VFVN30,HOSE,20050,21450,18650,19550,20000,20000,19430,19620,19550,20000,20000,19430,19620,-500,-500,-2493.8,651000000,1.27717E+13,200000000,3.9461E+12,851000000,1.67178E+13
10/2/23,E1VFVN30,HOSE,20140,21540,18740,20050,20160,20180,19980,20050,20050,20160,20180,19980,20050,-90,-90,-446.9,665900000,1.33534E+13,100000000,2.0129E+12,765900000,1.53663E+13
9/29/23,E1VFVN30,HOSE,20000,21400,18600,20140,20020,20240,20000,20110,20140,20020,20240,20000,20110,140,140,700,85700000,1.72366E+12,500000000,1.00668E+13,585700000,1.17905E+13
9/28/23,E1VFVN30,HOSE,20000,21400,18600,20000,20000,20050,19720,19970,20000,20000,20050,19720,19970,0,0,0,328100000,6.55149E+12,0,0,328100000,6.55149E+12
9/27/23,E1VFVN30,HOSE,19990,21380,18600,20000,19990,20000,19670,19850,20000,19990,20000,19670,19850,10,10,50,1562300000,3.10137E+13,2550000000,5.05853E+13,4112300000,8.15989E+13
9/26/23,E1VFVN30,HOSE,20560,21990,19130,19990,20780,20780,19850,20020,19990,20780,20780,19850,20020,-570,-570,-2772.4,993600000,1.98954E+13,4500000000,9.0278E+13,5493600000,1.10173E+14
9/25/23,E1VFVN30,HOSE,20700,22140,19260,20560,20710,21400,20100,20370,20560,20710,21400,20100,20370,-140,-140,-676.3,775600000,1.57968E+13,500000000,1.01884E+13,1275600000,2.59852E+13
9/22/23,E1VFVN30,HOSE,21040,22510,19570,20700,21090,21090,20320,20450,20700,21090,21090,20320,20450,-340,-340,-1616,1421700000,2.9074E+13,100000000,2.0424E+12,1521700000,3.11164E+13
9/21/23,E1VFVN30,HOSE,21250,22730,19770,21040,21440,21440,20980,21110,21040,21440,21440,20980,21110,-210,-210,-988.2,296800000,6.26689E+12,2800000000,5.88972E+13,3096800000,6.51641E+13
9/20/23,E1VFVN30,HOSE,21200,22680,19720,21250,21230,21250,21040,21140,21250,21230,21250,21040,21140,50,50,235.8,82800000,1.7503E+12,200000000,4.2218E+12,282800000,5.9721E+12
9/19/23,E1VFVN30,HOSE,21070,22540,19600,21200,21020,21200,20870,21000,21200,21020,21200,20870,21000,130,130,617,459400000,9.64565E+12,0,0,459400000,9.64565E+12
9/18/23,E1VFVN30,HOSE,21340,22830,19850,21070,21350,21350,20910,21120,21070,21350,21350,20910,21120,-270,-270,-1265.2,455200000,9.61409E+12,400000000,8.3756E+12,855200000,1.79897E+13
9/15/23,E1VFVN30,HOSE,21230,22710,19750,21340,21690,21690,21240,21330,21340,21690,21690,21240,21330,110,110,518.1,78100000,1.66582E+12,0,0,78100000,1.66582E+12
9/14/23,E1VFVN30,HOSE,21480,22980,19980,21230,21480,21590,21200,21340,21230,21480,21590,21200,21340,-250,-250,-1163.9,273700000,5.8419E+12,1300000000,2.77969E+13,1573700000,3.36388E+13
9/13/23,E1VFVN30,HOSE,21790,23310,20270,21480,21900,21900,21330,21530,21480,21900,21900,21330,21530,-310,-310,-1422.7,275500000,5.93252E+12,1400000000,3.00332E+13,1675500000,3.59657E+13
9/12/23,E1VFVN30,HOSE,21100,22570,19630,21790,21320,21790,21140,21360,21790,21320,21790,21140,21360,690,690,3270.1,647100000,1.38194E+13,200000000,4.235E+12,847100000,1.80544E+13
9/11/23,E1VFVN30,HOSE,21540,23040,20040,21100,21570,21650,21100,21400,21100,21570,21650,21100,21400,-440,-440,-2042.7,194400000,4.15952E+12,1200000000,2.54928E+13,1394400000,2.96523E+13
9/8/23,E1VFVN30,HOSE,21570,23070,20070,21540,21650,21650,21500,21550,21540,21650,21650,21500,21550,-30,-30,-139.1,610800000,1.31657E+13,900000000,1.94479E+13,1510800000,3.26136E+13
9/7/23,E1VFVN30,HOSE,21640,23150,20130,21570,21640,21820,21550,21730,21570,21640,21820,21550,21730,-70,-70,-323.5,537100000,1.16716E+13,1900000000,4.10283E+13,2437100000,5.26999E+13
9/6/23,E1VFVN30,HOSE,21380,22870,19890,21640,21380,21640,21290,21400,21640,21380,21640,21290,21400,260,260,1216.1,1143200000,2.44595E+13,1000000000,2.14936E+13,2143200000,4.59531E+13
9/5/23,E1VFVN30,HOSE,21200,22680,19720,21380,21200,21490,21200,21380,21380,21200,21490,21200,21380,180,180,849.1,1264400000,2.70304E+13,300000000,6.4233E+12,1564400000,3.34537E+13
8/31/23,E1VFVN30,HOSE,21080,22550,19610,21200,21090,21300,21090,21220,21200,21090,21300,21090,21220,120,120,569.3,186100000,3.94863E+12,0,0,186100000,3.94863E+12
8/30/23,E1VFVN30,HOSE,20900,22360,19440,21080,20950,21100,20880,20990,21080,20950,21100,20880,20990,180,180,861.2,597600000,1.25438E+13,200000000,4.2068E+12,797600000,1.67506E+13
8/29/23,E1VFVN30,HOSE,20800,22250,19350,20900,20800,20930,20750,20850,20900,20800,20930,20750,20850,100,100,480.8,573500000,1.19559E+13,700000000,1.4596E+13,1273500000,2.65519E+13
8/28/23,E1VFVN30,HOSE,20560,21990,19130,20800,20720,20830,20600,20700,20800,20720,20830,20600,20700,240,240,1167.3,791500000,1.63819E+13,300000000,6.2361E+12,1091500000,2.2618E+13
8/25/23,E1VFVN30,HOSE,20640,22080,19200,20560,20640,20700,20540,20580,20560,20640,20700,20540,20580,-80,-80,-387.6,298500000,6.14408E+12,0,0,298500000,6.14408E+12
8/24/23,E1VFVN30,HOSE,20440,21870,19010,20640,20440,20700,20000,20420,20640,20440,20700,20000,20420,200,200,978.5,349100000,7.12978E+12,0,0,349100000,7.12978E+12
8/23/23,E1VFVN30,HOSE,20550,21980,19120,20440,20830,20830,20330,20470,20440,20830,20830,20330,20470,-110,-110,-535.3,422700000,8.65141E+12,200000000,4.0556E+12,622700000,1.2707E+13
8/22/23,E1VFVN30,HOSE,20450,21880,19020,20550,20450,20800,19980,20330,20550,20450,20800,19980,20330,100,100,489,524700000,1.06672E+13,4000000000,8.12722E+13,4524700000,9.19394E+13
8/21/23,E1VFVN30,HOSE,20400,21820,18980,20450,20400,21000,20300,20430,20450,20400,21000,20300,20430,50,50,245.1,1520500000,3.10642E+13,10400000000,2.1245E+14,11920500000,2.43514E+14
8/18/23,E1VFVN30,HOSE,21460,22960,19960,20400,21460,21470,19960,20870,20400,21460,21470,19960,20870,-1060,-1060,-4939.4,1893900000,3.95202E+13,5800000000,1.21048E+14,7693900000,1.60569E+14
8/17/23,E1VFVN30,HOSE,21420,22910,19930,21460,21420,21630,21420,21570,21460,21420,21630,21420,21570,40,40,186.7,2472200000,5.33331E+13,600000000,1.2936E+13,3072200000,6.62691E+13
8/16/23,E1VFVN30,HOSE,21290,22780,19800,21420,21290,21590,21290,21500,21420,21290,21590,21290,21500,130,130,610.6,637200000,1.37024E+13,1100000000,2.36064E+13,1737200000,3.73088E+13
8/15/23,E1VFVN30,HOSE,21210,22690,19730,21290,21020,21370,21020,21260,21290,21020,21370,21020,21260,80,80,377.2,3309300000,7.03555E+13,500000000,1.06515E+13,3809300000,8.1007E+13
8/14/23,E1VFVN30,HOSE,21210,22690,19730,21210,21220,21400,21210,21320,21210,21220,21400,21210,21320,0,0,0,3283900000,7.00123E+13,2000000000,4.2504E+13,5283900000,1.12516E+14
8/11/23,E1VFVN30,HOSE,21100,22570,19630,21210,21260,21360,20960,21105.20706,21210,21260,21360,20960,21105.20706,110,110,521.3,6285700000,1.32661E+14,160000000,34007000,6445700000,1.32661E+14
8/10/23,E1VFVN30,HOSE,21270,22750,19790,21100,21300,21360,21060,21190,21100,21300,21360,21060,21190,-170,-170,-799.2,3677700000,7.79355E+13,500000000,1.06185E+13,4177700000,8.8554E+13
8/9/23,E1VFVN30,HOSE,21380,22870,19890,21270,21390,21390,21110,21250,21270,21390,21390,21110,21250,-110,-110,-514.5,173900000,3.69462E+12,6450000000,1.36821E+14,6623900000,1.40516E+14
8/8/23,E1VFVN30,HOSE,21390,22880,19900,21380,21400,21500,21270,21370,21380,21400,21500,21270,21370,-10,-10,-46.8,1808100000,3.86455E+13,100000000,2.1467E+12,1908100000,4.07922E+13
8/7/23,E1VFVN30,HOSE,21140,22610,19670,21390,21200,21390,21000,21230,21390,21200,21390,21000,21230,250,250,1182.6,481900000,1.02311E+13,1600000000,3.40284E+13,2081900000,4.42595E+13
8/4/23,E1VFVN30,HOSE,20700,22140,19260,21140,20700,21200,20700,20980,21140,20700,21200,20700,20980,440,440,2125.6,552700000,1.15934E+13,3700000000,7.77265E+13,4252700000,8.93199E+13
8/3/23,E1VFVN30,HOSE,20900,22360,19440,20700,20900,20980,20690,20860,20700,20900,20980,20690,20860,-200,-200,-956.9,504600000,1.05267E+13,1400000000,2.92226E+13,1904600000,3.97493E+13
8/2/23,E1VFVN30,HOSE,21020,22490,19550,20900,21020,21020,20830,20960,20900,21020,21020,20830,20960,-120,-120,-570.9,1644200000,3.44599E+13,7300000000,1.52934E+14,8944200000,1.87394E+14
8/1/23,E1VFVN30,HOSE,21200,22680,19720,21020,21560,21590,21000,21200,21020,21560,21590,21000,21200,-180,-180,-849.1,2810100000,5.95745E+13,2400000000,5.1021E+13,5210100000,1.10596E+14
7/31/23,E1VFVN30,HOSE,20750,22200,19300,21200,20930,21200,20930,20990,21200,20930,21200,20930,20990,450,450,2168.7,540800000,1.13497E+13,1400000000,2.95476E+13,1940800000,4.08973E+13
7/28/23,E1VFVN30,HOSE,20530,21960,19100,20750,20650,20800,20550,20670,20750,20650,20800,20550,20670,220,220,1071.6,712800000,1.47355E+13,1200000000,2.4828E+13,1912800000,3.95635E+13
7/27/23,E1VFVN30,HOSE,20550,21980,19120,20530,20550,20680,20500,20580,20530,20550,20680,20500,20580,-20,-20,-97.3,105800000,2.17717E+12,1000000000,2.05991E+13,1105800000,2.27763E+13
7/26/23,E1VFVN30,HOSE,20500,21930,19070,20550,20500,20600,20500,20540,20550,20500,20600,20500,20540,50,50,243.9,89100000,1.8299E+12,100000000,2.0556E+12,189100000,3.8855E+12
7/25/23,E1VFVN30,HOSE,20390,21810,18970,20500,20390,20650,20390,20550,20500,20390,20650,20390,20550,110,110,539.5,1364000000,2.80289E+13,300000000,6.1701E+12,1664000000,3.4199E+13
7/24/23,E1VFVN30,HOSE,20250,21660,18840,20390,20300,20480,20300,20380,20390,20300,20480,20300,20380,140,140,691.4,146800000,2.99215E+12,500000000,1.02066E+13,646800000,1.31988E+13
7/21/23,E1VFVN30,HOSE,20010,21410,18610,20250,20010,20290,20010,20170,20250,20010,20290,20010,20170,240,240,1199.4,150800000,3.0415E+12,0,0,150800000,3.0415E+12
7/20/23,E1VFVN30,HOSE,20110,21510,18710,20010,20090,20090,19970,20000,20010,20090,20090,19970,20000,-100,-100,-497.3,89700000,1.79402E+12,300000000,5.9964E+12,389700000,7.79042E+12
7/19/23,E1VFVN30,HOSE,20030,21430,18630,20110,20030,20110,20030,20060,20110,20030,20110,20030,20060,80,80,399.4,114700000,2.30035E+12,1900000000,3.8088E+13,2014700000,4.03884E+13
7/18/23,E1VFVN30,HOSE,20000,21400,18600,20030,20000,20050,19950,20020,20030,20000,20050,19950,20020,30,30,150,216700000,4.33727E+12,0,0,216700000,4.33727E+12
7/17/23,E1VFVN30,HOSE,19860,21250,18470,20000,19890,20050,19880,20000,20000,19890,20050,19880,20000,140,140,704.9,282300000,5.64637E+12,1000000000,1.99735E+13,1282300000,2.56199E+13
7/14/23,E1VFVN30,HOSE,19800,21180,18420,19860,19810,19940,19700,19850,19860,19810,19940,19700,19850,60,60,303,78000000,1.54793E+12,200000000,3.9656E+12,278000000,5.51353E+12
7/13/23,E1VFVN30,HOSE,19600,20970,18230,19800,19620,19800,19620,19760,19800,19620,19800,19620,19760,200,200,1020.4,99400000,1.96433E+12,200000000,3.9452E+12,299400000,5.90953E+12
7/12/23,E1VFVN30,HOSE,19600,20970,18230,19600,19770,19820,19600,19660,19600,19770,19820,19600,19660,0,0,0,59900000,1.17763E+12,0,0,59900000,1.17763E+12
7/11/23,E1VFVN30,HOSE,19540,20900,18180,19600,19740,19750,19600,19670,19600,19740,19750,19600,19670,60,60,307.1,549600000,1.0808E+13,0,0,549600000,1.0808E+13
7/10/23,E1VFVN30,HOSE,19410,20760,18060,19540,19420,19580,19410,19530,19540,19420,19580,19410,19530,130,130,669.8,1275500000,2.49156E+13,780000000,1.52328E+13,2055500000,4.01484E+13
7/7/23,E1VFVN30,HOSE,19400,20750,18050,19410,19400,19410,19160,19240,19410,19400,19410,19160,19240,10,10,51.5,1050800000,2.02207E+13,1400000000,2.69442E+13,2450800000,4.71649E+13
7/6/23,E1VFVN30,HOSE,19460,20820,18100,19400,19300,19470,19200,19420,19400,19300,19470,19200,19420,-60,-60,-308.3,577400000,1.12123E+13,600000000,1.1613E+13,1177400000,2.28253E+13
7/5/23,E1VFVN30,HOSE,19300,20650,17950,19460,19300,19500,19300,19460,19460,19300,19500,19300,19460,160,160,829,2743000000,5.33773E+13,400000000,7.774E+12,3143000000,6.11513E+13
7/4/23,E1VFVN30,HOSE,19200,20540,17860,19300,19210,19300,19200,19240,19300,19210,19300,19200,19240,100,100,520.8,406600000,7.82139E+12,300000000,5.7819E+12,706600000,1.36033E+13
7/3/23,E1VFVN30,HOSE,19350,20700,18000,19200,19400,19400,19200,19240,19200,19400,19400,19200,19240,-150,-150,-775.2,640100000,1.23186E+13,0,0,640100000,1.23186E+13
6/30/23,E1VFVN30,HOSE,19300,20650,17950,19350,19350,19450,19210,19240,19350,19350,19450,19210,19240,50,50,259.1,318400000,6.12646E+12,600000000,1.15825E+13,918400000,1.7709E+13
6/29/23,E1VFVN30,HOSE,19590,20960,18220,19300,19590,19590,19300,19400,19300,19590,19590,19300,19400,-290,-290,-1480.3,263600000,5.11276E+12,1800000000,3.50193E+13,2063600000,4.01321E+13
6/28/23,E1VFVN30,HOSE,19380,20730,18030,19590,19410,19590,19400,19440,19590,19410,19590,19400,19440,210,210,1083.6,291300000,5.66257E+12,2900000000,5.64631E+13,3191300000,6.21257E+13
6/27/23,E1VFVN30,HOSE,19360,20710,18010,19380,19450,19500,19350,19380,19380,19450,19500,19350,19380,20,20,103.3,510300000,9.88961E+12,1500000000,2.9085E+13,2010300000,3.89746E+13
6/26/23,E1VFVN30,HOSE,19290,20640,17940,19360,19340,19400,19100,19290,19360,19340,19400,19100,19290,70,70,362.9,687100000,1.32524E+13,1900000000,3.66753E+13,2587100000,4.99277E+13
6/23/23,E1VFVN30,HOSE,19130,20460,17800,19290,19200,19320,19190,19240,19290,19200,19320,19190,19240,160,160,836.4,628600000,1.2093E+13,500000000,9.6663E+12,1128600000,2.17593E+13
6/22/23,E1VFVN30,HOSE,18950,20270,17630,19130,19240,19250,19000,19180,19130,19240,19250,19000,19180,180,180,949.9,70100000,1.34461E+12,0,0,70100000,1.34461E+12
6/21/23,E1VFVN30,HOSE,18880,20200,17560,18950,18990,19000,18900,18950,18950,18990,19000,18900,18950,70,70,370.8,86500000,1.63931E+12,900000000,1.70734E+13,986500000,1.87127E+13
6/20/23,E1VFVN30,HOSE,18890,20210,17570,18880,18900,18900,18810,18860,18880,18900,18900,18810,18860,-10,-10,-52.9,41200000,7.76953E+11,0,0,41200000,7.76953E+11
6/19/23,E1VFVN30,HOSE,19000,20330,17670,18890,19000,19070,18790,18880,18890,19000,19070,18790,18880,-110,-110,-578.9,1069900000,2.01997E+13,0,0,1069900000,2.01997E+13
6/16/23,E1VFVN30,HOSE,19000,20330,17670,19000,19000,19250,19000,19130,19000,19000,19250,19000,19130,0,0,0,565600000,1.08171E+13,100000000,1.767E+12,665600000,1.25841E+13
6/15/23,E1VFVN30,HOSE,19100,20430,17770,19000,19100,19120,19000,19090,19000,19100,19120,19000,19090,-100,-100,-523.6,167200000,3.1916E+12,1800000000,3.41316E+13,1967200000,3.73232E+13
6/14/23,E1VFVN30,HOSE,19030,20360,17700,19100,19050,19240,19050,19150,19100,19050,19240,19050,19150,70,70,367.8,467400000,8.94946E+12,800000000,1.53468E+13,1267400000,2.42963E+13
6/13/23,E1VFVN30,HOSE,18880,20200,17560,19030,18890,19050,18890,19010,19030,18890,19050,18890,19010,150,150,794.5,540700000,1.02765E+13,600000000,1.14219E+13,1140700000,2.16984E+13
6/12/23,E1VFVN30,HOSE,18740,20050,17430,18880,18800,18880,18710,18800,18880,18800,18880,18710,18800,140,140,747.1,104700000,1.96795E+12,1300000000,2.44938E+13,1404700000,2.64617E+13
6/9/23,E1VFVN30,HOSE,18760,20070,17450,18740,18760,18800,18640,18720,18740,18760,18800,18640,18720,-20,-20,-106.6,72600000,1.35931E+12,1300000000,2.43956E+13,1372600000,2.57549E+13
6/8/23,E1VFVN30,HOSE,18820,20130,17510,18760,18850,19000,18760,18850,18760,18850,19000,18760,18850,-60,-60,-318.8,79200000,1.49293E+12,0,0,79200000,1.49293E+12
6/7/23,E1VFVN30,HOSE,18640,19940,17340,18820,18820,18900,18810,18860,18820,18820,18900,18810,18860,180,180,965.7,108800000,2.0522E+12,900000000,1.7022E+13,1008800000,1.90742E+13
6/6/23,E1VFVN30,HOSE,18500,19790,17210,18640,18650,18770,18640,18720,18640,18650,18770,18640,18720,140,140,756.8,155500000,2.91029E+12,600000000,1.12427E+13,755500000,1.4153E+13
6/5/23,E1VFVN30,HOSE,18630,19930,17330,18500,18600,18880,18500,18710,18500,18600,18880,18500,18710,-130,-130,-697.8,301600000,5.64183E+12,600000000,1.1229E+13,901600000,1.68708E+13
6/2/23,E1VFVN30,HOSE,18200,19470,16930,18630,18340,18630,18330,18520,18630,18340,18630,18330,18520,430,430,2362.6,184500000,3.41741E+12,1100000000,2.04342E+13,1284500000,2.38516E+13
6/1/23,E1VFVN30,HOSE,18410,19690,17130,18200,18410,18450,18200,18220,18200,18410,18450,18200,18220,-210,-210,-1140.7,156400000,2.85002E+12,200000000,3.6413E+12,356400000,6.49132E+12
5/31/23,E1VFVN30,HOSE,18250,19520,16980,18410,18300,18410,18200,18360,18410,18300,18410,18200,18360,160,160,876.7,149000000,2.73614E+12,300000000,5.4714E+12,449000000,8.20754E+12
5/30/23,E1VFVN30,HOSE,18200,19470,16930,18250,18300,18380,18200,18260,18250,18300,18380,18200,18260,50,50,274.7,383600000,7.00301E+12,500000000,9.147E+12,883600000,1.615E+13
5/29/23,E1VFVN30,HOSE,18050,19310,16790,18200,18060,18230,18060,18170,18200,18060,18230,18060,18170,150,150,831,286400000,5.20432E+12,700000000,1.27239E+13,986400000,1.79282E+13
5/26/23,E1VFVN30,HOSE,18090,19350,16830,18050,18110,18120,18040,18070,18050,18110,18120,18040,18070,-40,-40,-221.1,40400000,7.30108E+11,400000000,7.2388E+12,440400000,7.96891E+12
5/25/23,E1VFVN30,HOSE,18120,19380,16860,18090,18100,18120,17980,18030,18090,18100,18120,17980,18030,-30,-30,-165.6,1140300000,2.05603E+13,100000000,1.8095E+12,1240300000,2.23698E+13
5/24/23,E1VFVN30,HOSE,18010,19270,16750,18120,18240,18250,18120,18230,18120,18240,18250,18120,18230,110,110,610.8,1492300000,2.72063E+13,200000000,3.6334E+12,1692300000,3.08397E+13
5/23/23,E1VFVN30,HOSE,18280,19550,17010,18010,18290,18400,18010,18280,18010,18290,18400,18010,18280,-270,-270,-1477,587100000,1.07321E+13,1400000000,2.54733E+13,1987100000,3.62054E+13
5/22/23,E1VFVN30,HOSE,18200,19470,16930,18280,18200,18300,18190,18240,18280,18200,18300,18190,18240,80,80,439.6,530700000,9.67925E+12,2000000000,3.65013E+13,2530700000,4.61806E+13
5/19/23,E1VFVN30,HOSE,18300,19580,17020,18200,18150,18300,18040,18120,18200,18150,18300,18040,18120,-100,-100,-546.4,935800000,1.69577E+13,3500000000,6.34635E+13,4435800000,8.04212E+13
5/18/23,E1VFVN30,HOSE,18030,19290,16770,18300,18040,18300,18040,18210,18300,18040,18300,18040,18210,270,270,1497.5,57900000,1.05424E+12,1100000000,2.00932E+13,1157900000,2.11474E+13
5/17/23,E1VFVN30,HOSE,18230,19500,16960,18030,18230,18320,18030,18190,18030,18230,18320,18030,18190,-200,-200,-1097.1,107000000,1.94631E+12,900000000,1.64429E+13,1007000000,1.83892E+13
5/16/23,E1VFVN30,HOSE,18240,19510,16970,18230,18380,18390,18170,18260,18230,18380,18390,18170,18260,-10,-10,-54.8,297800000,5.43755E+12,500000000,9.1305E+12,797800000,1.45681E+13
5/15/23,E1VFVN30,HOSE,18160,19430,16890,18240,18180,18420,18170,18310,18240,18180,18420,18170,18310,80,80,440.5,102800000,1.88205E+12,1940000000,3.54873E+13,2042800000,3.73693E+13
5/12/23,E1VFVN30,HOSE,17990,19240,16740,18160,17990,18160,17900,18020,18160,17990,18160,17900,18020,170,170,945,1227300000,2.21218E+13,2500000000,4.50643E+13,3727300000,6.71861E+13
5/11/23,E1VFVN30,HOSE,18020,19280,16760,17990,18020,18080,17960,18020,17990,18020,18080,17960,18020,-30,-30,-166.5,96000000,1.7298E+12,200000000,3.6026E+12,296000000,5.3324E+12
5/10/23,E1VFVN30,HOSE,18000,19260,16740,18020,18000,18020,17890,17940,18020,18000,18020,17890,17940,20,20,111.1,254800000,4.57054E+12,0,0,254800000,4.57054E+12
5/9/23,E1VFVN30,HOSE,18000,19260,16740,18000,18100,18110,17860,17910,18000,18100,18110,17860,17910,0,0,0,684300000,1.2256E+13,1200000000,2.1432E+13,1884300000,3.3688E+13
5/8/23,E1VFVN30,HOSE,18000,19260,16740,18000,17970,18000,17750,17810,18000,17970,18000,17750,17810,0,0,0,541300000,9.64243E+12,700000000,1.24514E+13,1241300000,2.20938E+13
5/5/23,E1VFVN30,HOSE,17930,19180,16680,18000,17930,18000,17680,17790,18000,17930,18000,17680,17790,70,70,390.4,230900000,4.10867E+12,0,0,230900000,4.10867E+12
5/4/23,E1VFVN30,HOSE,18200,19470,16930,17930,18050,18050,17700,17840,17930,18050,18050,17700,17840,-270,-270,-1483.5,252800000,4.5096E+12,0,0,252800000,4.5096E+12
4/28/23,E1VFVN30,HOSE,17780,19020,16540,18200,17940,18200,17800,17980,18200,17940,18200,17800,17980,420,420,2362.2,77200000,1.38782E+12,4200000000,7.4781E+13,4277200000,7.61688E+13
4/27/23,E1VFVN30,HOSE,17920,19170,16670,17780,17960,17960,17750,17830,17780,17960,17960,17750,17830,-140,-140,-781.3,63700000,1.13559E+12,0,0,63700000,1.13559E+12
4/26/23,E1VFVN30,HOSE,17700,18930,16470,17920,17700,18080,17600,17700,17920,17700,18080,17600,17700,220,220,1242.9,195000000,3.4516E+12,0,0,195000000,3.4516E+12
4/25/23,E1VFVN30,HOSE,17900,19150,16650,17700,17890,17960,17700,17830,17700,17890,17960,17700,17830,-200,-200,-1117.3,289900000,5.1702E+12,100000000,1.7833E+12,389900000,6.9535E+12
4/24/23,E1VFVN30,HOSE,17890,19140,16640,17900,18000,18030,17780,17880,17900,18000,18030,17780,17880,10,10,55.9,474900000,8.49324E+12,5000000000,8.89913E+13,5474900000,9.74845E+13
4/21/23,E1VFVN30,HOSE,18060,19320,16800,17890,18170,18170,17870,17950,17890,18170,18170,17870,17950,-170,-170,-941.3,322800000,5.79449E+12,0,0,322800000,5.79449E+12
4/20/23,E1VFVN30,HOSE,18070,19330,16810,18060,18070,18090,17970,18020,18060,18070,18090,17970,18020,-10,-10,-55.3,241500000,4.35298E+12,0,0,241500000,4.35298E+12
4/19/23,E1VFVN30,HOSE,18170,19440,16900,18070,18180,18270,18020,18160,18070,18180,18270,18020,18160,-100,-100,-550.4,420700000,7.63981E+12,100000000,1.8155E+12,520700000,9.45531E+12
4/18/23,E1VFVN30,HOSE,18200,19470,16930,18170,18220,18230,18130,18170,18170,18220,18230,18130,18170,-30,-30,-164.8,194700000,3.53826E+12,200000000,3.6295E+12,394700000,7.16776E+12
4/17/23,E1VFVN30,HOSE,18300,19580,17020,18200,18250,18290,18100,18160,18200,18250,18290,18100,18160,-100,-100,-546.4,242200000,4.39954E+12,300000000,5.4346E+12,542200000,9.83414E+12
4/14/23,E1VFVN30,HOSE,18340,19620,17060,18300,18590,18590,18230,18330,18300,18590,18590,18230,18330,-40,-40,-218.1,492400000,9.02494E+12,0,0,492400000,9.02494E+12
4/13/23,E1VFVN30,HOSE,18490,19780,17200,18340,18500,18500,18330,18410,18340,18500,18500,18330,18410,-150,-150,-811.2,230100000,4.23543E+12,0,0,230100000,4.23543E+12
4/12/23,E1VFVN30,HOSE,18550,19840,17260,18490,18550,18570,18400,18450,18490,18550,18570,18400,18450,-60,-60,-323.5,801700000,1.47944E+13,100000000,1.8438E+12,901700000,1.66382E+13
4/11/23,E1VFVN30,HOSE,18380,19660,17100,18550,18410,18550,18130,18320,18550,18410,18550,18130,18320,170,170,924.9,295400000,5.41095E+12,0,0,295400000,5.41095E+12
4/10/23,E1VFVN30,HOSE,18380,19660,17100,18380,18400,18540,18350,18470,18380,18400,18540,18350,18470,0,0,0,589100000,1.08791E+13,300000000,5.5516E+12,889100000,1.64307E+13
4/7/23,E1VFVN30,HOSE,18500,19790,17210,18380,18500,18500,18290,18340,18380,18500,18500,18290,18340,-120,-120,-648.6,336500000,6.17275E+12,200000000,3.6683E+12,536500000,9.84105E+12
4/6/23,E1VFVN30,HOSE,18600,19900,17300,18500,18670,18670,18500,18610,18500,18670,18670,18500,18610,-100,-100,-537.6,376400000,7.00543E+12,4000000000,7.4216E+13,4376400000,8.12214E+13
4/5/23,E1VFVN30,HOSE,18620,19920,17320,18600,18500,18600,18480,18550,18600,18500,18600,18480,18550,-20,-20,-107.4,254000000,4.71068E+12,600000000,1.1088E+13,854000000,1.57987E+13
4/4/23,E1VFVN30,HOSE,18570,19860,17280,18620,18600,18620,18520,18560,18620,18600,18620,18520,18560,50,50,269.3,1799800000,3.34036E+13,1900000000,3.51789E+13,3699800000,6.85825E+13
4/3/23,E1VFVN30,HOSE,18400,19680,17120,18570,18500,19580,18470,18540,18570,18500,19580,18470,18540,170,170,923.9,1514600000,2.80742E+13,1300000000,2.40547E+13,2814600000,5.21289E+13
3/31/23,E1VFVN30,HOSE,18220,19490,16950,18400,18340,18400,18250,18320,18400,18340,18400,18250,18320,180,180,987.9,315600000,5.78167E+12,500000000,9.1663E+12,815600000,1.4948E+13
3/30/23,E1VFVN30,HOSE,18030,19290,16770,18220,18200,18290,18180,18230,18220,18200,18290,18180,18230,190,190,1053.8,218900000,3.99012E+12,300000000,5.4705E+12,518900000,9.46062E+12
3/29/23,E1VFVN30,HOSE,18180,19450,16910,18030,18180,18180,17980,18050,18030,18180,18180,17980,18050,-150,-150,-825.1,769000000,1.38811E+13,200000000,3.6046E+12,969000000,1.74857E+13
3/28/23,E1VFVN30,HOSE,17980,19230,16730,18180,18100,18180,18000,18100,18180,18100,18180,18000,18100,200,200,1112.3,442700000,8.01326E+12,1600000000,2.8919E+13,2042700000,3.69323E+13
3/27/23,E1VFVN30,HOSE,17970,19220,16720,17980,18010,18200,17850,17950,17980,18010,18200,17850,17950,10,10,55.6,357000000,6.40891E+12,3100000000,5.55501E+13,3457000000,6.1959E+13
3/24/23,E1VFVN30,HOSE,17770,19010,16530,17970,17850,18030,17850,17970,17970,17850,18030,17850,17970,200,200,1125.5,277800000,4.99132E+12,100000000,1.7999E+12,377800000,6.79122E+12
3/23/23,E1VFVN30,HOSE,17840,19080,16600,17770,17640,17830,17610,17750,17770,17640,17830,17610,17750,-70,-70,-392.4,312800000,5.55237E+12,0,0,312800000,5.55237E+12
3/22/23,E1VFVN30,HOSE,17600,18830,16370,17840,17680,17840,17680,17750,17840,17680,17840,17680,17750,240,240,1363.6,422100000,7.49021E+12,3800000000,6.72309E+13,4222100000,7.47211E+13
3/21/23,E1VFVN30,HOSE,17400,18610,16190,17600,17530,17650,17370,17540,17600,17530,17650,17370,17540,200,200,1149.4,329800000,5.78534E+12,0,0,329800000,5.78534E+12
3/20/23,E1VFVN30,HOSE,17800,19040,16560,17400,17710,17770,17400,17660,17400,17710,17770,17400,17660,-400,-400,-2247.2,1076500000,1.90115E+13,200000000,3.486E+12,1276500000,2.24975E+13
3/17/23,E1VFVN30,HOSE,17770,19010,16530,17800,17830,18060,17790,17860,17800,17830,18060,17790,17860,30,30,168.8,259900000,4.64185E+12,0,0,259900000,4.64185E+12
3/16/23,E1VFVN30,HOSE,18120,19380,16860,17770,18120,18120,17770,17880,17770,18120,18120,17770,17880,-350,-350,-1931.6,686100000,1.22672E+13,2300000000,4.10593E+13,2986100000,5.33265E+13
3/15/23,E1VFVN30,HOSE,17640,18870,16410,18120,17840,18800,17840,18080,18120,17840,18800,17840,18080,480,480,2721.1,768500000,1.3898E+13,5600000000,1.00883E+14,6368500000,1.14781E+14
3/14/23,E1VFVN30,HOSE,17870,19120,16620,17640,17870,17890,17590,17660,17640,17870,17890,17590,17660,-230,-230,-1287.1,245900000,4.34262E+12,2300000000,4.06876E+13,2545900000,4.50302E+13
3/13/23,E1VFVN30,HOSE,17850,19090,16610,17870,17700,17920,17700,17860,17870,17700,17920,17700,17860,20,20,112,617800000,1.10331E+13,1800000000,3.21607E+13,2417800000,4.31938E+13
3/10/23,E1VFVN30,HOSE,17930,19180,16680,17850,17840,17850,17670,17780,17850,17840,17850,17670,17780,-80,-80,-446.2,2243000000,3.98891E+13,2900000000,5.1597E+13,5143000000,9.14861E+13
3/9/23,E1VFVN30,HOSE,17700,18930,16470,17930,17700,17970,17700,17850,17930,17700,17970,17700,17850,230,230,1299.4,2184000000,3.89899E+13,2000000000,3.56255E+13,4184000000,7.46154E+13
3/8/23,E1VFVN30,HOSE,17450,18670,16230,17700,17400,17700,17340,17460,17700,17400,17700,17340,17460,250,250,1432.7,1446400000,2.52501E+13,3000000000,5.22177E+13,4446400000,7.74678E+13
3/7/23,E1VFVN30,HOSE,17300,18510,16090,17450,17590,17690,17390,17570,17450,17590,17690,17390,17570,150,150,867.1,1079000000,1.89531E+13,700000000,1.23025E+13,1779000000,3.12556E+13
3/6/23,E1VFVN30,HOSE,17270,18470,16070,17300,17510,17890,17300,17570,17300,17510,17890,17300,17570,30,30,173.7,150600000,2.64676E+12,2000000000,3.5386E+13,2150600000,3.80328E+13
3/3/23,E1VFVN30,HOSE,17650,18880,16420,17270,17800,17800,17270,17440,17270,17800,17800,17270,17440,-380,-380,-2153,78500000,1.36872E+12,300000000,5.2305E+12,378500000,6.59922E+12
3/2/23,E1VFVN30,HOSE,17540,18760,16320,17650,17540,17730,17440,17590,17650,17540,17730,17440,17590,110,110,627.1,517500000,9.10038E+12,3300000000,5.84456E+13,3817500000,6.7546E+13
3/1/23,E1VFVN30,HOSE,17300,18510,16090,17540,17200,17700,17060,17260,17540,17200,17700,17060,17260,240,240,1387.3,543000000,9.37391E+12,1150000000,1.99392E+13,1693000000,2.93131E+13
2/28/23,E1VFVN30,HOSE,17220,18420,16020,17300,17420,17420,17170,17310,17300,17420,17420,17170,17310,80,80,464.6,530700000,9.18493E+12,800000000,1.38791E+13,1330700000,2.3064E+13
2/27/23,E1VFVN30,HOSE,17720,18960,16480,17220,17660,17660,17050,17190,17220,17660,17660,17050,17190,-500,-500,-2821.7,373900000,6.42772E+12,1300000000,2.24242E+13,1673900000,2.88519E+13
2/24/23,E1VFVN30,HOSE,17980,19230,16730,17720,17970,17970,17480,17610,17720,17970,17970,17480,17610,-260,-260,-1446.1,138000000,2.43055E+12,2203500000,3.87683E+13,2341500000,4.11988E+13
2/23/23,E1VFVN30,HOSE,18010,19270,16750,17980,17940,18020,17500,17660,17980,17940,18020,17500,17660,-30,-30,-166.6,613100000,1.08258E+13,4100000000,7.28475E+13,4713100000,8.36733E+13
2/22/23,E1VFVN30,HOSE,18400,19680,17120,18010,18340,18340,18010,18160,18010,18340,18340,18010,18160,-390,-390,-2119.6,616100000,1.11855E+13,100000000,1.8234E+12,716100000,1.30089E+13
2/21/23,E1VFVN30,HOSE,18320,19600,17040,18400,18450,18660,18370,18430,18400,18450,18660,18370,18430,80,80,436.7,262000000,4.82845E+12,2000000000,3.70232E+13,2262000000,4.18517E+13
2/20/23,E1VFVN30,HOSE,17860,19110,16610,18320,17910,18420,17900,18220,18320,17910,18420,17900,18220,460,460,2575.6,205200000,3.7396E+12,1500000000,2.74375E+13,1705200000,3.11771E+13
2/17/23,E1VFVN30,HOSE,17920,19170,16670,17860,18000,18000,17850,17930,17860,18000,18000,17850,17930,-60,-60,-334.8,429700000,7.70474E+12,1300000000,2.32898E+13,1729700000,3.09945E+13
2/16/23,E1VFVN30,HOSE,17740,18980,16500,17920,17970,17970,17750,17810,17920,17970,17970,17750,17810,180,180,1014.7,892400000,1.58952E+13,1100000000,1.96171E+13,1992400000,3.55123E+13
2/15/23,E1VFVN30,HOSE,17650,18880,16420,17740,17730,17930,17600,17790,17740,17730,17930,17600,17790,90,90,509.9,2201300000,3.91648E+13,1800000000,3.1991E+13,4001300000,7.11558E+13
2/14/23,E1VFVN30,HOSE,17790,19030,16550,17650,18200,18200,17590,17680,17650,18200,18200,17590,17680,-140,-140,-787,306100000,5.41293E+12,800000000,1.41467E+13,1106100000,1.95596E+13
2/13/23,E1VFVN30,HOSE,18120,19380,16860,17790,18120,18120,17480,17670,17790,18120,18120,17480,17670,-330,-330,-1821.2,347300000,6.13687E+12,400000000,7.0098E+12,747300000,1.31467E+13
2/10/23,E1VFVN30,HOSE,18120,19380,16860,18120,18120,18140,17880,18060,18120,18120,18140,17880,18060,0,0,0,558300000,1.00818E+13,0,0,558300000,1.00818E+13
2/9/23,E1VFVN30,HOSE,18380,19660,17100,18120,18340,18370,18120,18260,18120,18340,18370,18120,18260,-260,-260,-1414.6,173700000,3.17156E+12,700000000,1.2754E+13,873700000,1.59256E+13
2/8/23,E1VFVN30,HOSE,18490,19780,17200,18380,18750,18750,18210,18360,18380,18750,18750,18210,18360,-110,-110,-594.9,382200000,7.01558E+12,800000000,1.45818E+13,1182200000,2.15974E+13
2/7/23,E1VFVN30,HOSE,18560,19850,17270,18490,18580,18730,18300,18500,18490,18580,18730,18300,18500,-70,-70,-377.2,2557200000,4.73193E+13,2200000000,4.06293E+13,4757200000,8.79486E+13
2/6/23,E1VFVN30,HOSE,18490,19780,17200,18560,18400,18630,18280,18440,18560,18400,18630,18280,18440,70,70,378.6,208000000,3.83489E+12,800000000,1.47351E+13,1008000000,1.857E+13
2/3/23,E1VFVN30,HOSE,18550,19840,17260,18490,18690,18700,18440,18580,18490,18690,18700,18440,18580,-60,-60,-323.5,132700000,2.46588E+12,500000000,9.2281E+12,632700000,1.1694E+13
2/2/23,E1VFVN30,HOSE,18520,19810,17230,18550,18720,18720,18470,18580,18550,18720,18720,18470,18580,30,30,162,176600000,3.28178E+12,1300000000,2.41233E+13,1476600000,2.74051E+13
2/1/23,E1VFVN30,HOSE,19200,20540,17860,18520,19300,19300,18510,18960,18520,19300,19300,18510,18960,-680,-680,-3541.7,353500000,6.70287E+12,2300000000,4.34508E+13,2653500000,5.01537E+13
1/31/23,E1VFVN30,HOSE,19000,20330,17670,19200,19000,19200,18720,18870,19200,19000,19200,18720,18870,200,200,1052.6,142300000,2.68475E+12,550000000,1.04012E+13,692300000,1.30859E+13
1/30/23,E1VFVN30,HOSE,19210,20550,17870,19000,19250,19270,19000,19130,19000,19250,19270,19000,19130,-210,-210,-1093.2,519200000,9.93466E+12,6684000000,1.26503E+14,7203200000,1.36437E+14
1/27/23,E1VFVN30,HOSE,19400,20750,18050,19210,19400,19440,19210,19350,19210,19400,19440,19210,19350,-190,-190,-979.4,1285700000,2.48837E+13,400000000,7.7458E+12,1685700000,3.26295E+13
1/19/23,E1VFVN30,HOSE,19000,20330,17670,19400,19000,19400,18950,19130,19400,19000,19400,18950,19130,400,400,2105.3,490400000,9.38184E+12,1800000000,3.42334E+13,2290400000,4.36152E+13
1/18/23,E1VFVN30,HOSE,18780,20090,17470,19000,18800,19000,18800,18900,19000,18800,19000,18800,18900,220,220,1171.5,199800000,3.77711E+12,1900000000,3.59349E+13,2099800000,3.9712E+13
1/17/23,E1VFVN30,HOSE,18250,19520,16980,18780,18350,18800,18350,18590,18780,18350,18800,18350,18590,530,530,2904.1,934500000,1.73713E+13,3535000000,6.58159E+13,4469500000,8.31872E+13
1/16/23,E1VFVN30,HOSE,18360,19640,17080,18250,18360,18380,18110,18250,18250,18360,18380,18110,18250,-110,-110,-599.1,320300000,5.84633E+12,2900000000,5.30301E+13,3220300000,5.88764E+13
1/13/23,E1VFVN30,HOSE,18130,19390,16870,18360,18160,18360,18160,18280,18360,18160,18360,18160,18280,230,230,1268.6,3086000000,5.64095E+13,3800000000,6.9481E+13,6886000000,1.2589E+14
1/12/23,E1VFVN30,HOSE,18080,19340,16820,18130,18200,18490,18050,18170,18130,18200,18490,18050,18170,50,50,276.5,2097700000,3.81075E+13,0,0,2097700000,3.81075E+13
1/11/23,E1VFVN30,HOSE,18070,19330,16810,18080,18120,18300,18080,18200,18080,18120,18300,18080,18200,10,10,55.3,294700000,5.36249E+12,300000000,5.4625E+12,594700000,1.0825E+13
1/10/23,E1VFVN30,HOSE,18050,19310,16790,18070,18500,18560,18000,18110,18070,18500,18560,18000,18110,20,20,110.8,2247900000,4.07098E+13,3500000000,6.3326E+13,5747900000,1.04036E+14
1/9/23,E1VFVN30,HOSE,17980,19230,16730,18050,18300,18360,18040,18120,18050,18300,18360,18040,18120,70,70,389.3,2387100000,4.32631E+13,3100000000,5.61906E+13,5487100000,9.94537E+13
1/6/23,E1VFVN30,HOSE,18070,19330,16810,17980,18080,18240,17980,18200,17980,18080,18240,17980,18200,-90,-90,-498.1,547300000,9.95939E+12,2020000000,3.67358E+13,2567300000,4.66951E+13
1/5/23,E1VFVN30,HOSE,17900,19150,16650,18070,17900,18130,17900,18020,18070,17900,18130,17900,18020,170,170,949.7,120900000,2.17855E+12,1600000000,2.87524E+13,1720900000,3.09309E+13
1/4/23,E1VFVN30,HOSE,17700,18930,16470,17900,17770,17950,17770,17880,17900,17770,17950,17770,17880,200,200,1129.9,88400000,1.58073E+12,700000000,1.2531E+13,788400000,1.41117E+13
1/3/23,E1VFVN30,HOSE,17330,18540,16120,17700,17370,17700,17240,17470,17700,17370,17700,17240,17470,370,370,2135,82900000,1.44785E+12,2500000000,4.35487E+13,2582900000,4.49966E+13
12/30/22,E1VFVN30,HOSE,17230,18430,16030,17330,17490,17490,17110,17250,17330,17490,17490,17110,17250,100,100,580.4,68700000,1.18476E+12,900000000,1.55026E+13,968700000,1.66874E+13
12/29/22,E1VFVN30,HOSE,17400,18610,16190,17230,17400,17500,17230,17280,17230,17400,17500,17230,17280,-170,-170,-977,69800000,1.20628E+12,1500000000,2.58477E+13,1569800000,2.7054E+13
12/28/22,E1VFVN30,HOSE,17500,18720,16280,17400,17500,17500,17030,17110,17400,17500,17500,17030,17110,-100,-100,-571.4,387300000,6.62698E+12,2600000000,4.45194E+13,2987300000,5.11464E+13
12/27/22,E1VFVN30,HOSE,17160,18360,15960,17500,17000,17600,16870,17000,17500,17000,17600,16870,17000,340,340,1981.4,859000000,1.46031E+13,2000000000,3.39047E+13,2859000000,4.85078E+13
12/26/22,E1VFVN30,HOSE,17700,18930,16470,17160,17530,17720,17000,17270,17160,17530,17720,17000,17270,-540,-540,-3050.8,160900000,2.77875E+12,2500000000,4.33283E+13,2660900000,4.61071E+13
12/23/22,E1VFVN30,HOSE,17700,18930,16470,17700,17700,17730,17410,17570,17700,17700,17730,17410,17570,0,0,0,1174100000,2.06252E+13,2000000000,3.51915E+13,3174100000,5.58167E+13
12/22/22,E1VFVN30,HOSE,17430,18650,16210,17700,17460,17860,17460,17750,17700,17460,17860,17460,17750,270,270,1549.1,344000000,6.1072E+12,800000000,1.416E+13,1144000000,2.02672E+13
12/21/22,E1VFVN30,HOSE,17590,18820,16360,17430,17620,17900,17270,17580,17430,17620,17900,17270,17580,-160,-160,-909.6,1239000000,2.17794E+13,1800000000,3.15524E+13,3039000000,5.33318E+13
12/20/22,E1VFVN30,HOSE,17990,19240,16740,17590,17940,17940,17270,17390,17590,17940,17940,17270,17390,-400,-400,-2223.5,857600000,1.49149E+13,2400000000,4.23276E+13,3257600000,5.72425E+13
12/19/22,E1VFVN30,HOSE,18180,19450,16910,17990,18070,18370,17990,18220,17990,18070,18370,17990,18220,-190,-190,-1045.1,560600000,1.02152E+13,4000000000,7.19116E+13,4560600000,8.21268E+13
12/16/22,E1VFVN30,HOSE,18300,19580,17020,18180,18200,18350,18010,18160,18180,18200,18350,18010,18160,-120,-120,-655.7,94700000,1.71943E+12,700000000,1.27733E+13,794700000,1.44927E+13
12/15/22,E1VFVN30,HOSE,17960,19210,16710,18300,18190,18300,18000,18210,18300,18190,18300,18000,18210,340,340,1893.1,150400000,2.73881E+12,1100000000,2.03392E+13,1250400000,2.3078E+13
12/14/22,E1VFVN30,HOSE,17900,19150,16650,17960,18000,18280,17950,18065,17960,18000,18280,17950,18065,60,60,335.2,68200000,1.23273E+12,2200000000,3.9589E+13,2268200000,4.08217E+13
12/13/22,E1VFVN30,HOSE,17800,19040,16560,17900,17800,17900,17470,17670,17900,17800,17900,17470,17670,100,100,561.8,1163300000,2.05579E+13,2600000000,4.59813E+13,3763300000,6.65392E+13
12/12/22,E1VFVN30,HOSE,18180,19450,16910,17800,18200,18320,17700,18040,17800,18200,18320,17700,18040,-380,-380,-2090.2,92700000,1.67241E+12,0,0,92700000,1.67241E+12
12/9/22,E1VFVN30,HOSE,18100,19360,16840,18180,18160,18320,17880,18090,18180,18160,18320,17880,18090,80,80,442,339500000,6.14154E+12,2700000000,4.91317E+13,3039500000,5.52732E+13
12/8/22,E1VFVN30,HOSE,18000,19260,16740,18100,18040,18620,18040,18330,18100,18040,18620,18040,18330,100,100,555.6,1701900000,3.11884E+13,5900000000,1.08741E+14,7601900000,1.39929E+14
12/7/22,E1VFVN30,HOSE,18100,19360,16840,18000,18100,18110,17700,17990,18000,18100,18110,17700,17990,-100,-100,-552.5,1240100000,2.2313E+13,1700000000,3.03807E+13,2940100000,5.26937E+13
12/6/22,E1VFVN30,HOSE,18890,20210,17570,18100,18900,18900,18100,18570,18100,18900,18900,18100,18570,-790,-790,-4182.1,2055400000,3.81698E+13,5300000000,9.77814E+13,7355400000,1.35951E+14
12/5/22,E1VFVN30,HOSE,18500,19790,17210,18890,18560,19100,18560,18870,18890,18560,19100,18560,18870,390,390,2108.1,1204700000,2.27304E+13,1800000000,3.38748E+13,3004700000,5.66052E+13
12/2/22,E1VFVN30,HOSE,18100,19360,16840,18500,18000,18500,17510,17950,18500,18000,18500,17510,17950,400,400,2209.9,1723500000,3.09437E+13,7200000000,1.31931E+14,8923500000,1.62875E+14
12/1/22,E1VFVN30,HOSE,17800,19040,16560,18100,18160,18260,17600,18030,18100,18160,18260,17600,18030,300,300,1685.4,1069100000,1.92725E+13,7200000000,1.29336E+14,8269100000,1.48609E+14
11/30/22,E1VFVN30,HOSE,17340,18550,16130,17800,17350,17800,17300,17550,17800,17350,17800,17300,17550,460,460,2652.8,405200000,7.11313E+12,6200000000,1.08108E+14,6605200000,1.15221E+14
11/29/22,E1VFVN30,HOSE,16850,18020,15680,17340,17150,17340,16950,17200,17340,17150,17340,16950,17200,490,490,2908,1016800000,1.7484E+13,6700000000,1.15202E+14,7716800000,1.32686E+14
11/28/22,E1VFVN30,HOSE,16410,17550,15270,16850,16510,17180,16510,16950,16850,16510,17180,16510,16950,440,440,2681.3,674400000,1.14326E+13,2700000000,4.5899E+13,3374400000,5.73316E+13
11/25/22,E1VFVN30,HOSE,16020,17140,14900,16410,16200,16410,16200,16280,16410,16200,16410,16200,16280,390,390,2434.5,547000000,8.9066E+12,800000000,1.29558E+13,1347000000,2.18624E+13
11/24/22,E1VFVN30,HOSE,16060,17180,14940,16020,16100,16100,15780,15840,16020,16100,16100,15780,15840,-40,-40,-249.1,875900000,1.38718E+13,2200000000,3.49873E+13,3075900000,4.88591E+13
11/23/22,E1VFVN30,HOSE,16120,17240,15000,16060,16120,16200,15900,16010,16060,16120,16200,15900,16010,-60,-60,-372.2,1833900000,2.93606E+13,3500000000,5.58553E+13,5333900000,8.52159E+13
11/22/22,E1VFVN30,HOSE,16290,17430,15150,16120,16290,16800,16020,16290,16120,16290,16800,16020,16290,-170,-170,-1043.6,2349700000,3.82689E+13,3200000000,5.28358E+13,5549700000,9.11047E+13
11/21/22,E1VFVN30,HOSE,16650,17810,15490,16290,16700,16700,16170,16380,16290,16700,16700,16170,16380,-360,-360,-2162.2,225400000,3.69124E+12,1100000000,1.78996E+13,1325400000,2.15908E+13
11/18/22,E1VFVN30,HOSE,16510,17660,15360,16650,16600,16680,16000,16230,16650,16600,16680,16000,16230,140,140,848,712500000,1.1566E+13,1100000000,1.79192E+13,1812500000,2.94852E+13
11/17/22,E1VFVN30,HOSE,16150,17280,15020,16510,16300,16680,16210,16400,16510,16300,16680,16210,16400,360,360,2229.1,2987100000,4.90002E+13,2600000000,4.26723E+13,5587100000,9.16725E+13
11/16/22,E1VFVN30,HOSE,15300,16370,14230,16150,15150,16200,14660,15360,16150,15150,16200,14660,15360,850,850,5555.6,1438300000,2.20945E+13,4500000000,6.6993E+13,5938300000,8.90875E+13
11/15/22,E1VFVN30,HOSE,15800,16900,14700,15300,15800,15800,15230,15420,15300,15800,15800,15230,15420,-500,-500,-3164.6,1287500000,1.98503E+13,1200000000,1.853E+13,2487500000,3.83803E+13
11/14/22,E1VFVN30,HOSE,15200,16260,14140,15800,15800,15920,15510,15810,15800,15800,15920,15510,15810,600,600,3947.4,2975400000,4.70429E+13,900000000,1.44021E+13,3875400000,6.1445E+13
11/11/22,E1VFVN30,HOSE,15600,16690,14510,15200,16000,16380,15200,16000,15200,16000,16380,15200,16000,-400,-400,-2564.1,1636000000,2.61764E+13,6500000000,1.04614E+14,8136000000,1.30791E+14
11/10/22,E1VFVN30,HOSE,16540,17690,15390,15600,16750,16750,15600,15860,15600,16750,16750,15600,15860,-940,-940,-5683.2,920100000,1.45965E+13,6200000000,9.94605E+13,7120100000,1.14057E+14
11/9/22,E1VFVN30,HOSE,16560,17710,15410,16540,16590,16910,16500,16670,16540,16590,16910,16500,16670,-20,-20,-120.8,172900000,2.88219E+12,4100000000,6.83072E+13,4272900000,7.11894E+13
11/8/22,E1VFVN30,HOSE,16550,17700,15400,16560,16580,16700,16200,16410,16560,16580,16700,16200,16410,10,10,60.4,739000000,1.21299E+13,5000000000,8.15777E+13,5739000000,9.37076E+13
11/7/22,E1VFVN30,HOSE,16930,18110,15750,16550,17050,17050,16500,16670,16550,17050,17050,16500,16670,-380,-380,-2244.5,352900000,5.88116E+12,4700000000,7.82155E+13,5052900000,8.40967E+13
11/4/22,E1VFVN30,HOSE,17420,18630,16210,16930,17420,17600,16550,16900,16930,17420,17600,16550,16900,-490,-490,-2812.9,868500000,1.46762E+13,6100000000,1.02203E+14,6968500000,1.16879E+14
11/3/22,E1VFVN30,HOSE,17390,18600,16180,17420,17070,17550,17070,17390,17420,17070,17550,17070,17390,30,30,172.5,205200000,3.56888E+12,500000000,8.6867E+12,705200000,1.22556E+13
11/2/22,E1VFVN30,HOSE,17520,18740,16300,17390,17520,17670,17390,17490,17390,17520,17670,17390,17490,-130,-130,-742,218300000,3.81707E+12,900000000,1.57145E+13,1118300000,1.95316E+13
11/1/22,E1VFVN30,HOSE,17580,18810,16350,17520,17580,17810,17500,17650,17520,17580,17810,17500,17650,-60,-60,-341.3,447600000,7.90066E+12,800000000,1.40873E+13,1247600000,2.1988E+13
10/31/22,E1VFVN30,HOSE,17500,18720,16280,17580,17510,17580,17000,17270,17580,17510,17580,17000,17270,80,80,457.1,282300000,4.87438E+12,700000000,1.20238E+13,982300000,1.68982E+13
10/28/22,E1VFVN30,HOSE,17340,18550,16130,17500,17500,17840,17450,17610,17500,17500,17840,17450,17610,160,160,922.7,239500000,4.21765E+12,300000000,5.248E+12,539500000,9.46565E+12
10/27/22,E1VFVN30,HOSE,16680,17840,15520,17340,16710,17340,16710,17020,17340,16710,17340,16710,17020,660,660,3956.8,499500000,8.50314E+12,700000000,1.16562E+13,1199500000,2.01593E+13
10/26/22,E1VFVN30,HOSE,16610,17770,15450,16680,16800,17400,16610,16730,16680,16800,17400,16610,16730,70,70,421.4,407000000,6.80945E+12,1400000000,2.32265E+13,1807000000,3.00359E+13
10/25/22,E1VFVN30,HOSE,16500,17650,15350,16610,16500,17000,16100,16600,16610,16500,17000,16100,16600,110,110,666.7,1273700000,2.11391E+13,1800000000,2.923E+13,3073700000,5.03691E+13
10/24/22,E1VFVN30,HOSE,17090,18280,15900,16500,17300,17350,16330,16580,16500,17300,17350,16330,16580,-590,-590,-3452.3,971900000,1.61175E+13,0,0,971900000,1.61175E+13
10/21/22,E1VFVN30,HOSE,17920,19170,16670,17090,17830,17830,17000,17650,17090,17830,17830,17000,17650,-830,-830,-4631.7,1034800000,1.82649E+13,1850000000,3.18437E+13,2884800000,5.01085E+13
10/20/22,E1VFVN30,HOSE,18010,19270,16750,17920,17980,17980,17700,17760,17920,17980,17980,17700,17760,-90,-90,-499.7,1036600000,1.8408E+13,1150000000,2.05567E+13,2186600000,3.89647E+13
10/19/22,E1VFVN30,HOSE,17950,19200,16700,18010,18000,18010,17730,17950,18010,18000,18010,17730,17950,60,60,334.3,744100000,1.33572E+13,1400000000,2.51888E+13,2144100000,3.8546E+13
10/18/22,E1VFVN30,HOSE,17750,18990,16510,17950,17910,18140,17900,18010,17950,17910,18140,17900,18010,200,200,1126.8,748100000,1.34759E+13,690800000,1.21928E+13,1438900000,2.56686E+13
10/17/22,E1VFVN30,HOSE,18000,19260,16740,17750,17940,17940,17460,17670,17750,17940,17940,17460,17670,-250,-250,-1388.9,1332300000,2.35395E+13,0,0,1332300000,2.35395E+13
10/14/22,E1VFVN30,HOSE,17700,18930,16470,18000,17810,18140,17810,18000,18000,17810,18140,17810,18000,300,300,1694.9,608500000,1.09514E+13,0,0,608500000,1.09514E+13
10/13/22,E1VFVN30,HOSE,17540,18760,16320,17700,17650,17700,17110,17450,17700,17650,17700,17110,17450,160,160,912.2,1081300000,1.88696E+13,0,0,1081300000,1.88696E+13
10/12/22,E1VFVN30,HOSE,16860,18040,15680,17540,16950,17610,16910,17450,17540,16950,17610,16910,17450,680,680,4033.2,762400000,1.33058E+13,2225000000,3.88577E+13,2987400000,5.21635E+13
10/11/22,E1VFVN30,HOSE,17600,18830,16370,16860,17400,17500,16780,17100,16860,17400,17500,16780,17100,-740,-740,-4204.5,963200000,1.64685E+13,2200000000,3.73519E+13,3163200000,5.38204E+13
10/10/22,E1VFVN30,HOSE,17660,18890,16430,17600,17580,17820,17150,17470,17600,17580,17820,17150,17470,-60,-60,-339.8,370300000,6.4696E+12,1800000000,3.17585E+13,2170300000,3.82281E+13
10/7/22,E1VFVN30,HOSE,18720,20030,17410,17660,18600,18650,17550,17740,17660,18600,18650,17550,17740,-1060,-1060,-5662.4,864600000,1.5334E+13,2800000000,5.13224E+13,3664600000,6.66564E+13
10/6/22,E1VFVN30,HOSE,18980,20300,17660,18720,19270,19270,18500,18600,18720,19270,19270,18500,18600,-260,-260,-1369.9,540000000,1.00453E+13,2000000000,3.78158E+13,2540000000,4.78611E+13
10/5/22,E1VFVN30,HOSE,18500,19790,17210,18980,18800,19130,18800,18970,18980,18800,19130,18800,18970,480,480,2594.6,164100000,3.11264E+12,1000000000,1.86919E+13,1164100000,2.18045E+13
10/4/22,E1VFVN30,HOSE,18800,20110,17490,18500,18810,18980,18500,18760,18500,18810,18980,18500,18760,-300,-300,-1595.7,1652800000,3.10147E+13,3300000000,6.22772E+13,4952800000,9.32919E+13
10/3/22,E1VFVN30,HOSE,19920,21310,18530,18800,19880,19880,18740,18970,18800,19880,19880,18740,18970,-1120,-1120,-5622.5,1028200000,1.95012E+13,1100000000,2.12984E+13,2128200000,4.07996E+13
9/30/22,E1VFVN30,HOSE,19900,21290,18510,19920,20000,20000,19210,19390,19920,20000,20000,19210,19390,20,20,100.5,2073700000,4.02142E+13,10200000000,1.97427E+14,12273700000,2.37641E+14
9/29/22,E1VFVN30,HOSE,20170,21580,18760,19900,20180,20180,19660,19770,19900,20180,20180,19660,19770,-270,-270,-1338.6,2786600000,5.5082E+13,3600000000,7.1148E+13,6386600000,1.2623E+14
9/28/22,E1VFVN30,HOSE,20230,21640,18820,20170,20200,20300,19800,19930,20170,20200,20300,19800,19930,-60,-60,-296.6,913100000,1.82016E+13,0,0,913100000,1.82016E+13
9/27/22,E1VFVN30,HOSE,20270,21680,18860,20230,20260,20290,20080,20140,20230,20260,20290,20080,20140,-40,-40,-197.3,1883200000,3.79248E+13,600000000,1.2105E+13,2483200000,5.00298E+13
9/26/22,E1VFVN30,HOSE,20820,22270,19370,20270,20640,20640,20020,20170,20270,20640,20640,20020,20170,-550,-550,-2641.7,1354700000,2.73259E+13,0,0,1354700000,2.73259E+13
9/23/22,E1VFVN30,HOSE,20820,22270,19370,20820,20820,20830,20570,20720,20820,20820,20830,20570,20720,0,0,0,544900000,1.1289E+13,0,0,544900000,1.1289E+13
9/22/22,E1VFVN30,HOSE,20720,22170,19270,20820,20700,20850,20570,20640,20820,20700,20850,20570,20640,100,100,482.6,401600000,8.28919E+12,0,0,401600000,8.28919E+12
9/21/22,E1VFVN30,HOSE,20930,22390,19470,20720,20990,20990,20720,20810,20720,20990,20990,20720,20810,-210,-210,-1003.3,82700000,1.7211E+12,100000000,2.0843E+12,182700000,3.8054E+12
9/20/22,E1VFVN30,HOSE,20950,22410,19490,20930,21000,21030,20780,20860,20930,21000,21030,20780,20860,-20,-20,-95.5,156500000,3.26485E+12,200000000,4.1752E+12,356500000,7.44005E+12
9/19/22,E1VFVN30,HOSE,21050,22520,19580,20950,21120,21240,20850,21070,20950,21120,21240,20850,21070,-100,-100,-475.1,553500000,1.1664E+13,100000000,2.1113E+12,653500000,1.37753E+13
9/16/22,E1VFVN30,HOSE,21410,22900,19920,21050,21430,21430,21050,21300,21050,21430,21430,21050,21300,-360,-360,-1681.5,391500000,8.33789E+12,5000000000,1.056E+14,5391500000,1.13938E+14
9/15/22,E1VFVN30,HOSE,21390,22880,19900,21410,21400,21800,21380,21460,21410,21400,21800,21380,21460,20,20,93.5,65900000,1.41401E+12,0,0,65900000,1.41401E+12
9/14/22,E1VFVN30,HOSE,21630,23140,20120,21390,21600,21600,21180,21270,21390,21600,21600,21180,21270,-240,-240,-1109.6,376400000,8.00631E+12,400000000,9.24E+12,776400000,1.72463E+13
9/13/22,E1VFVN30,HOSE,21700,23210,20190,21630,21700,21700,21550,21620,21630,21700,21700,21550,21620,-70,-70,-322.6,880600000,1.90373E+13,200000000,4.3863E+12,1080600000,2.34236E+13
9/12/22,E1VFVN30,HOSE,21540,23040,20040,21700,21700,21790,21630,21720,21700,21700,21790,21630,21720,160,160,742.8,1059300000,2.30131E+13,100000000,2.221E+12,1159300000,2.52341E+13
9/9/22,E1VFVN30,HOSE,21490,22990,19990,21540,21470,21570,21380,21500,21540,21470,21570,21380,21500,50,50,232.7,497100000,1.06866E+13,400000000,8.6083E+12,897100000,1.92949E+13
9/8/22,E1VFVN30,HOSE,21800,23320,20280,21490,21820,21820,21470,21560,21490,21820,21820,21470,21560,-310,-310,-1422,594500000,1.2817E+13,0,0,594500000,1.2817E+13
9/7/22,E1VFVN30,HOSE,21950,23480,20420,21800,21940,21940,21630,21810,21800,21940,21940,21630,21810,-150,-150,-683.4,1237900000,2.69982E+13,0,0,1237900000,2.69982E+13
9/6/22,E1VFVN30,HOSE,22060,23600,20520,21950,22060,22060,21860,21920,21950,22060,22060,21860,21920,-110,-110,-498.6,1383600000,3.03275E+13,0,0,1383600000,3.03275E+13
9/5/22,E1VFVN30,HOSE,22060,23600,20520,22060,22070,22080,21730,21970,22060,22070,22080,21730,21970,0,0,0,1550000000,3.40481E+13,200000000,4.3928E+12,1750000000,3.84409E+13
8/31/22,E1VFVN30,HOSE,22000,23540,20460,22060,22000,22060,21830,21950,22060,22000,22060,21830,21950,60,60,272.7,425800000,9.34447E+12,600000000,1.31812E+13,1025800000,2.25257E+13
8/30/22,E1VFVN30,HOSE,21810,23330,20290,22000,21850,22050,21850,21960,22000,21850,22050,21850,21960,190,190,871.2,245400000,5.38789E+12,0,0,245400000,5.38789E+12
8/29/22,E1VFVN30,HOSE,22120,23660,20580,21810,22000,22000,21660,21770,21810,22000,22000,21660,21770,-310,-310,-1401.4,861700000,1.87589E+13,300000000,6.5376E+12,1161700000,2.52965E+13
8/26/22,E1VFVN30,HOSE,22200,23750,20650,22120,22200,22310,22100,22250,22120,22200,22310,22100,22250,-80,-80,-360.4,234100000,5.20821E+12,200000000,4.4346E+12,434100000,9.64281E+12
8/25/22,E1VFVN30,HOSE,21910,23440,20380,22200,22000,22200,21960,22060,22200,22000,22200,21960,22060,290,290,1323.6,88700000,1.95649E+12,1700000000,3.76907E+13,1788700000,3.96472E+13
8/24/22,E1VFVN30,HOSE,21790,23310,20270,21910,21790,21930,21790,21860,21910,21790,21930,21790,21860,120,120,550.7,247200000,5.40385E+12,450000000,9.88375E+12,697200000,1.52876E+13
8/23/22,E1VFVN30,HOSE,21800,23320,20280,21790,21640,21790,21590,21680,21790,21640,21790,21590,21680,-10,-10,-45.9,295300000,6.40285E+12,200000000,4.3268E+12,495300000,1.07297E+13
8/22/22,E1VFVN30,HOSE,21800,23320,20280,21800,21940,21940,21750,21840,21800,21940,21940,21750,21840,0,0,0,463100000,1.01121E+13,0,0,463100000,1.01121E+13
8/19/22,E1VFVN30,HOSE,21920,23450,20390,21800,22060,22060,21800,22000,21800,22060,22060,21800,22000,-120,-120,-547.4,538400000,1.1847E+13,4200000000,9.2094E+13,4738400000,1.03941E+14
8/18/22,E1VFVN30,HOSE,22040,23580,20500,21920,22040,22120,21800,22030,21920,22040,22120,21800,22030,-120,-120,-544.5,419000000,9.23078E+12,0,0,419000000,9.23078E+12
8/17/22,E1VFVN30,HOSE,21900,23430,20370,22040,21950,22040,21930,22000,22040,21950,22040,21930,22000,140,140,639.3,72300000,1.59087E+12,0,0,72300000,1.59087E+12
8/16/22,E1VFVN30,HOSE,21860,23390,20330,21900,21880,21950,21850,21890,21900,21880,21950,21850,21890,40,40,183,61700000,1.3504E+12,100000000,2.192E+12,161700000,3.5424E+12
8/15/22,E1VFVN30,HOSE,21600,23110,20090,21860,21650,21870,21650,21790,21860,21650,21870,21650,21790,260,260,1203.7,607700000,1.3239E+13,0,0,607700000,1.3239E+13
8/12/22,E1VFVN30,HOSE,21670,23180,20160,21600,21590,21600,21490,21560,21600,21590,21600,21490,21560,-70,-70,-323,135300000,2.91716E+12,0,0,135300000,2.91716E+12
8/11/22,E1VFVN30,HOSE,21570,23070,20070,21670,21700,21850,21440,21720,21670,21700,21850,21440,21720,100,100,463.6,595500000,1.29364E+13,200000000,4.3176E+12,795500000,1.7254E+13
8/10/22,E1VFVN30,HOSE,21680,23190,20170,21570,21680,21700,21540,21620,21570,21680,21700,21540,21620,-110,-110,-507.4,354700000,7.66945E+12,300000000,6.4885E+12,654700000,1.41579E+13
8/9/22,E1VFVN30,HOSE,21430,22930,19930,21680,21450,21700,21450,21600,21680,21450,21700,21450,21600,250,250,1166.6,1020300000,2.20422E+13,0,0,1020300000,2.20422E+13
8/8/22,E1VFVN30,HOSE,21370,22860,19880,21430,21500,21620,21390,21440,21430,21500,21620,21390,21440,60,60,280.8,1178900000,2.52707E+13,5350000000,1.15731E+14,6528900000,1.41002E+14
8/5/22,E1VFVN30,HOSE,21500,23000,20000,21370,21250,21500,21250,21420,21370,21250,21500,21250,21420,-130,-130,-604.7,5711900000,1.22362E+14,8500000000,1.8395E+14,14211900000,3.06312E+14
8/4/22,E1VFVN30,HOSE,21200,22680,19720,21500,21240,21500,21240,21440,21500,21240,21500,21240,21440,300,300,1415.1,6552500000,1.40483E+14,1250000000,2.68233E+13,7802500000,1.67306E+14
8/3/22,E1VFVN30,HOSE,21300,22790,19810,21200,21290,21290,21020,21200,21200,21290,21290,21020,21200,-100,-100,-469.5,667200000,1.41423E+13,900000000,1.91499E+13,1567200000,3.32922E+13
8/2/22,E1VFVN30,HOSE,21100,22570,19630,21300,21100,21300,21080,21130,21300,21100,21300,21080,21130,200,200,947.9,1776100000,3.75298E+13,2570000000,5.38668E+13,4346100000,9.13966E+13
8/1/22,E1VFVN30,HOSE,20950,22410,19490,21100,20970,21100,20930,21010,21100,20970,21100,20930,21010,150,150,716,1461600000,3.07121E+13,200000000,4.1988E+12,1661600000,3.49109E+13
7/29/22,E1VFVN30,HOSE,20920,22380,19460,20950,21150,21150,20860,20940,20950,21150,21150,20860,20940,30,30,143.4,594100000,1.24395E+13,0,0,594100000,1.24395E+13
7/28/22,E1VFVN30,HOSE,20600,22040,19160,20920,20770,20980,20750,20890,20920,20770,20980,20750,20890,320,320,1553.4,326200000,6.81428E+12,1070000000,2.2042E+13,1396200000,2.88563E+13
7/27/22,E1VFVN30,HOSE,20690,22130,19250,20600,20600,20600,20500,20570,20600,20600,20600,20500,20570,-90,-90,-435,99700000,2.05044E+12,0,0,99700000,2.05044E+12
7/26/22,E1VFVN30,HOSE,20720,22170,19270,20690,20660,20720,20620,20690,20690,20660,20720,20620,20690,-30,-30,-144.8,78400000,1.62242E+12,1700000000,3.49979E+13,1778400000,3.66203E+13
7/25/22,E1VFVN30,HOSE,20890,22350,19430,20720,20810,20870,20600,20650,20720,20810,20870,20600,20650,-170,-170,-813.8,1201800000,2.4814E+13,100000000,2.0685E+12,1301800000,2.68825E+13
7/22/22,E1VFVN30,HOSE,20790,22240,19340,20890,20810,20940,20700,20810,20890,20810,20940,20700,20810,100,100,481,1075600000,2.23847E+13,100000000,2.0908E+12,1175600000,2.44755E+13
7/21/22,E1VFVN30,HOSE,20700,22140,19260,20790,20700,20880,20660,20760,20790,20700,20880,20660,20760,90,90,434.8,2127300000,4.41676E+13,0,0,2127300000,4.41676E+13
7/20/22,E1VFVN30,HOSE,20500,21930,19070,20700,20600,20760,20600,20700,20700,20600,20760,20600,20700,200,200,975.6,1049200000,2.17198E+13,0,0,1049200000,2.17198E+13
7/19/22,E1VFVN30,HOSE,20520,21950,19090,20500,20540,20540,20390,20460,20500,20540,20540,20390,20460,-20,-20,-97.5,848200000,1.73567E+13,0,0,848200000,1.73567E+13
7/18/22,E1VFVN30,HOSE,20630,22070,19190,20520,20650,20700,20520,20640,20520,20650,20700,20520,20640,-110,-110,-533.2,165900000,3.42501E+12,300000000,6.1638E+12,465900000,9.58881E+12
7/15/22,E1VFVN30,HOSE,20690,22130,19250,20630,20790,20790,20550,20680,20630,20790,20790,20550,20680,-60,-60,-290,623100000,1.28846E+13,0,0,623100000,1.28846E+13
7/14/22,E1VFVN30,HOSE,20630,22070,19190,20690,20600,20700,20440,20520,20690,20600,20700,20440,20520,60,60,290.8,1661900000,3.4098E+13,0,0,1661900000,3.4098E+13
7/13/22,E1VFVN30,HOSE,20600,22040,19160,20630,20650,20660,20470,20580,20630,20650,20660,20470,20580,30,30,145.6,1187900000,2.4449E+13,0,0,1187900000,2.4449E+13
7/12/22,E1VFVN30,HOSE,20370,21790,18950,20600,20400,20630,20400,20460,20600,20400,20630,20400,20460,230,230,1129.1,352200000,7.20671E+12,200000000,4.0768E+12,552200000,1.12835E+13
7/11/22,E1VFVN30,HOSE,20890,22350,19430,20370,20800,20800,20360,20500,20370,20800,20800,20360,20500,-520,-520,-2489.2,620600000,1.27213E+13,0,0,620600000,1.27213E+13
7/8/22,E1VFVN30,HOSE,20700,22140,19260,20890,20890,20890,20740,20800,20890,20890,20890,20740,20800,190,190,917.9,249500000,5.18932E+12,0,0,249500000,5.18932E+12
7/7/22,E1VFVN30,HOSE,20660,22100,19220,20700,20670,20700,20500,20600,20700,20670,20700,20500,20600,40,40,193.6,918000000,1.89117E+13,100000000,2.06E+12,1018000000,2.09717E+13
7/6/22,E1VFVN30,HOSE,20900,22360,19440,20660,20700,20900,20630,20820,20660,20700,20900,20630,20820,-240,-240,-1148.3,245000000,5.10162E+12,200000000,4.135E+12,445000000,9.23662E+12
7/5/22,E1VFVN30,HOSE,21260,22740,19780,20900,21290,21290,20900,21050,20900,21290,21290,20900,21050,-360,-360,-1693.3,559600000,1.17796E+13,0,0,559600000,1.17796E+13
7/4/22,E1VFVN30,HOSE,21300,22790,19810,21260,21280,21290,21050,21200,21260,21280,21290,21050,21200,-40,-40,-187.8,130600000,2.76934E+12,300000000,6.3394E+12,430600000,9.10874E+12
7/1/22,E1VFVN30,HOSE,21350,22840,19860,21300,21060,21300,20770,20880,21300,21060,21300,20770,20880,-50,-50,-234.2,556900000,1.16301E+13,200000000,4.2208E+12,756900000,1.58509E+13
6/30/22,E1VFVN30,HOSE,21450,22950,19950,21350,21450,21500,21220,21410,21350,21450,21500,21220,21410,-100,-100,-466.2,1233000000,2.63924E+13,0,0,1233000000,2.63924E+13
6/29/22,E1VFVN30,HOSE,21450,22950,19950,21450,21400,21500,21100,21430,21450,21400,21500,21100,21430,0,0,0,202900000,4.34842E+12,200000000,4.2881E+12,402900000,8.63652E+12
6/28/22,E1VFVN30,HOSE,21110,22580,19640,21450,21240,21500,21100,21250,21450,21240,21500,21100,21250,340,340,1610.6,811200000,1.72368E+13,0,0,811200000,1.72368E+13
6/27/22,E1VFVN30,HOSE,20790,22240,19340,21110,20810,21160,20810,21000,21110,20810,21160,20810,21000,320,320,1539.2,73000000,1.533E+12,0,0,73000000,1.533E+12
6/24/22,E1VFVN30,HOSE,20750,22200,19300,20790,21240,21240,20790,20950,20790,21240,21240,20790,20950,40,40,192.8,260800000,5.46347E+12,0,0,260800000,5.46347E+12
6/23/22,E1VFVN30,HOSE,20900,22360,19440,20750,20890,20890,20600,20750,20750,20890,20890,20600,20750,-150,-150,-717.7,349400000,7.25084E+12,1394500000,2.9152E+13,1743900000,3.64029E+13
6/22/22,E1VFVN30,HOSE,20600,22040,19160,20900,20720,20930,20620,20820,20900,20720,20930,20620,20820,300,300,1456.3,713900000,1.48653E+13,200000000,4.145E+12,913900000,1.90103E+13
6/21/22,E1VFVN30,HOSE,20710,22150,19270,20600,20510,20900,20440,20610,20600,20510,20900,20440,20610,-110,-110,-531.1,206400000,4.25442E+12,1550000000,3.21592E+13,1756400000,3.64136E+13
6/20/22,E1VFVN30,HOSE,21400,22890,19910,20710,21330,21330,20710,21050,20710,21330,21330,20710,21050,-690,-690,-3224.3,493800000,1.03952E+13,0,0,493800000,1.03952E+13
6/17/22,E1VFVN30,HOSE,21900,23430,20370,21400,21380,21500,20760,20910,21400,21380,21500,20760,20910,-500,-500,-2283.1,2391100000,4.99969E+13,1050000000,2.24673E+13,3441100000,7.24641E+13
6/16/22,E1VFVN30,HOSE,21010,22480,19540,21900,21150,22480,21150,21500,21900,21150,22480,21150,21500,890,890,4236.1,1657800000,3.56446E+13,800000000,1.7159E+13,2457800000,5.28036E+13
6/15/22,E1VFVN30,HOSE,21900,23430,20370,21010,21500,21500,20900,21190,21010,21500,21500,20900,21190,-890,-890,-4063.9,1248400000,2.64559E+13,4700000000,1.00013E+14,5948400000,1.26469E+14
6/14/22,E1VFVN30,HOSE,21740,23260,20220,21900,21500,21900,21010,21250,21900,21500,21900,21010,21250,160,160,736,760300000,1.61538E+13,300000000,6.1746E+12,1060300000,2.23284E+13
6/13/22,E1VFVN30,HOSE,22400,23960,20840,21740,22000,22000,21360,21720,21740,22000,22000,21360,21720,-660,-660,-2946.4,1586800000,3.44712E+13,0,0,1586800000,3.44712E+13
6/10/22,E1VFVN30,HOSE,22450,24020,20880,22400,22400,22530,22100,22440,22400,22400,22530,22100,22440,-50,-50,-222.7,1833900000,4.11464E+13,0,0,1833900000,4.11464E+13
6/9/22,E1VFVN30,HOSE,22400,23960,20840,22450,22500,22650,22400,22510,22450,22500,22650,22400,22510,50,50,223.2,1640400000,3.69176E+13,0,0,1640400000,3.69176E+13
6/8/22,E1VFVN30,HOSE,22350,23910,20790,22400,22350,22650,22330,22520,22400,22350,22650,22330,22520,50,50,223.7,1556000000,3.50483E+13,300000000,6.7683E+12,1856000000,4.18166E+13
6/7/22,E1VFVN30,HOSE,22350,23910,20790,22350,22340,22350,21800,21920,22350,22340,22350,21800,21920,0,0,0,690600000,1.51369E+13,300000000,6.5643E+12,990600000,2.17012E+13
6/6/22,E1VFVN30,HOSE,22100,23640,20560,22350,22110,22480,22100,22300,22350,22110,22480,22100,22300,250,250,1131.2,529100000,1.18004E+13,0,0,529100000,1.18004E+13
6/3/22,E1VFVN30,HOSE,22300,23860,20740,22100,22300,22350,22100,22230,22100,22300,22350,22100,22230,-200,-200,-896.9,420700000,9.35175E+12,300000000,6.645E+12,720700000,1.59967E+13
6/2/22,E1VFVN30,HOSE,22650,24230,21070,22300,22580,22610,22200,22510,22300,22580,22610,22200,22510,-350,-350,-1545.3,993700000,2.23659E+13,1000000000,2.24698E+13,1993700000,4.48357E+13
6/1/22,E1VFVN30,HOSE,22300,23860,20740,22650,22300,22650,22300,22460,22650,22300,22650,22300,22460,350,350,1569.5,242100000,5.43789E+12,0,0,242100000,5.43789E+12
5/31/22,E1VFVN30,HOSE,22600,24180,21020,22300,22510,22800,22220,22370,22300,22510,22800,22220,22370,-300,-300,-1327.4,4448900000,9.94998E+13,4300000000,9.6081E+13,8748900000,1.95581E+14
5/30/22,E1VFVN30,HOSE,22390,23950,20830,22600,22400,23800,22250,22410,22600,22400,23800,22250,22410,210,210,937.9,3980300000,8.91957E+13,3700000000,8.30649E+13,7680300000,1.72261E+14
5/27/22,E1VFVN30,HOSE,21930,23460,20400,22390,21930,22420,21930,22180,22390,21930,22420,21930,22180,460,460,2097.6,1459700000,3.23691E+13,2700000000,5.99958E+13,4159700000,9.23649E+13
5/26/22,E1VFVN30,HOSE,22000,23540,20460,21930,22000,22100,21900,21960,21930,22000,22100,21900,21960,-70,-70,-318.2,1065700000,2.34064E+13,3400000000,7.47838E+13,4465700000,9.81902E+13
5/25/22,E1VFVN30,HOSE,21320,22810,19830,22000,21480,22000,21330,21820,22000,21480,22000,21330,21820,680,680,3189.5,191400000,4.1763E+12,300000000,6.5336E+12,491400000,1.07099E+13
5/24/22,E1VFVN30,HOSE,21400,22890,19910,21320,21300,21450,20890,21120,21320,21300,21450,20890,21120,-80,-80,-373.8,428300000,9.04693E+12,1700000000,3.58851E+13,2128300000,4.4932E+13
5/23/22,E1VFVN30,HOSE,21680,23190,20170,21400,21700,21700,20980,21210,21400,21700,21700,20980,21210,-280,-280,-1291.5,612100000,1.29802E+13,1100000000,2.35046E+13,1712100000,3.64848E+13
5/20/22,E1VFVN30,HOSE,21680,23190,20170,21680,21700,21800,21340,21510,21680,21700,21800,21340,21510,0,0,0,753200000,1.62021E+13,1900000000,4.0796E+13,2653200000,5.69981E+13
5/19/22,E1VFVN30,HOSE,21800,23320,20280,21680,21180,21700,21100,21480,21680,21180,21700,21100,21480,-120,-120,-550.5,268200000,5.76155E+12,0,0,268200000,5.76155E+12
5/18/22,E1VFVN30,HOSE,21790,23310,20270,21800,21800,21850,21360,21580,21800,21800,21850,21360,21580,10,10,45.9,494100000,1.06617E+13,500000000,1.04961E+13,994100000,2.11578E+13
5/17/22,E1VFVN30,HOSE,20700,22140,19260,21790,20700,21790,20240,20840,21790,20700,21790,20240,20840,1090,1090,5265.7,1075100000,2.24046E+13,2000000000,4.13359E+13,3075100000,6.37405E+13
5/16/22,E1VFVN30,HOSE,21500,23000,20000,20700,21500,21500,20500,20970,20700,21500,21500,20500,20970,-800,-800,-3720.9,1756300000,3.68351E+13,0,0,1756300000,3.68351E+13
5/13/22,E1VFVN30,HOSE,21470,22970,19970,21500,21470,21500,20730,21320,21500,21470,21500,20730,21320,30,30,139.7,1640100000,3.49622E+13,300000000,6.4035E+12,1940100000,4.13657E+13
5/12/22,E1VFVN30,HOSE,22800,24390,21210,21470,22550,22550,21420,22260,21470,22550,22550,21420,22260,-1330,-1330,-5833.3,732300000,1.63031E+13,1300000000,2.84501E+13,2032300000,4.47532E+13
5/11/22,E1VFVN30,HOSE,23000,24610,21390,22800,22900,22900,22220,22500,22800,22900,22900,22220,22500,-200,-200,-869.6,2725200000,6.1317E+13,0,0,2725200000,6.1317E+13
5/10/22,E1VFVN30,HOSE,22000,23540,20460,23000,22000,23000,21660,22100,23000,22000,23000,21660,22100,1000,1000,4545.5,2449300000,5.41243E+13,4698000000,1.03531E+14,7147300000,1.57655E+14
5/9/22,E1VFVN30,HOSE,22990,24590,21390,22000,23080,23190,22000,22420,22000,23080,23190,22000,22420,-990,-990,-4306.2,600700000,1.34696E+13,400000000,8.9535E+12,1000700000,2.24231E+13
5/6/22,E1VFVN30,HOSE,23550,25190,21910,22990,23390,23400,22980,23250,22990,23390,23400,22980,23250,-560,-560,-2377.9,2092100000,4.8634E+13,0,0,2092100000,4.8634E+13
5/5/22,E1VFVN30,HOSE,23500,25140,21860,23550,23600,23600,23150,23470,23550,23600,23600,23150,23470,50,50,212.8,1397000000,3.27876E+13,1000000000,2.3397E+13,2397000000,5.61846E+13
5/4/22,E1VFVN30,HOSE,23960,25630,22290,23500,23990,23990,23420,23600,23500,23990,23990,23420,23600,-460,-460,-1919.9,261500000,6.17227E+12,0,0,261500000,6.17227E+12
4/29/22,E1VFVN30,HOSE,23890,25560,22220,23960,23890,23960,23500,23730,23960,23890,23960,23500,23730,70,70,293,491900000,1.16723E+13,220000000,5.20366E+12,711900000,1.6876E+13
4/28/22,E1VFVN30,HOSE,24000,25680,22320,23890,23900,23900,23460,23610,23890,23900,23900,23460,23610,-110,-110,-458.3,522800000,1.23437E+13,500000000,1.1739E+13,1022800000,2.40827E+13
4/27/22,E1VFVN30,HOSE,23550,25190,21910,24000,23770,24000,23030,23210,24000,23770,24000,23030,23210,450,450,1910.8,1737000000,4.03201E+13,800000000,1.86148E+13,2537000000,5.89349E+13
4/26/22,E1VFVN30,HOSE,23080,24690,21470,23550,23150,23550,22350,23000,23550,23150,23550,22350,23000,470,470,2036.4,856600000,1.9703E+13,3000000000,6.91519E+13,3856600000,8.88549E+13
4/25/22,E1VFVN30,HOSE,24800,26530,23070,23080,24780,24780,23070,23490,23080,24780,24780,23070,23490,-1720,-1720,-6935.5,2194600000,5.15492E+13,1000000000,2.4045E+13,3194600000,7.55942E+13
4/22/22,E1VFVN30,HOSE,24990,26730,23250,24800,24500,24990,24080,24310,24800,24500,24990,24080,24310,-190,-190,-760.3,1110800000,2.70072E+13,7000000000,1.68805E+14,8110800000,1.95812E+14
4/21/22,E1VFVN30,HOSE,24800,26530,23070,24990,24770,24990,24000,24180,24990,24770,24990,24000,24180,190,190,766.1,1165600000,2.81872E+13,5400000000,1.30811E+14,6565600000,1.58998E+14
4/20/22,E1VFVN30,HOSE,24950,26690,23210,24800,24950,25000,24180,24310,24800,24950,25000,24180,24310,-150,-150,-601.2,2026500000,4.92742E+13,6000000000,1.45733E+14,8026500000,1.95007E+14
4/19/22,E1VFVN30,HOSE,25300,27070,23530,24950,24930,25300,24440,24740,24950,24930,25300,24440,24740,-350,-350,-1383.4,787500000,1.94816E+13,7350000000,1.80946E+14,8137500000,2.00428E+14
4/18/22,E1VFVN30,HOSE,25500,27280,23720,25300,25440,25440,24730,24940,25300,25440,25440,24730,24940,-200,-200,-784.3,1568200000,3.91149E+13,1800000000,4.46334E+13,3368200000,8.37483E+13
4/15/22,E1VFVN30,HOSE,25520,27300,23740,25500,25600,25600,25160,25310,25500,25600,25600,25160,25310,-20,-20,-78.4,362600000,9.17722E+12,0,0,362600000,9.17722E+12
4/14/22,E1VFVN30,HOSE,25900,27710,24090,25520,25900,25900,25520,25720,25520,25900,25900,25520,25720,-380,-380,-1467.2,444300000,1.14274E+13,0,0,444300000,1.14274E+13
4/13/22,E1VFVN30,HOSE,25900,27710,24090,25900,25600,25900,25390,25510,25900,25600,25900,25390,25510,0,0,0,299200000,7.63214E+12,600000000,1.5285E+13,899200000,2.29171E+13
4/12/22,E1VFVN30,HOSE,25880,27690,24070,25900,25890,25900,25330,25520,25900,25890,25900,25330,25520,20,20,77.3,491500000,1.25454E+13,3100000000,7.93638E+13,3591500000,9.19092E+13
4/8/22,E1VFVN30,HOSE,25760,27560,23960,25880,25760,26000,25720,25830,25880,25760,26000,25720,25830,120,120,465.8,879400000,2.27166E+13,1000000000,2.5857E+13,1879400000,4.85736E+13
4/7/22,E1VFVN30,HOSE,25800,27600,24000,25760,25850,26210,25760,26080,25760,25850,26210,25760,26080,-40,-40,-155,2837000000,7.39927E+13,4510000000,1.17678E+14,7347000000,1.91671E+14
4/6/22,E1VFVN30,HOSE,25900,27710,24090,25800,25890,26100,25680,25950,25800,25890,26100,25680,25950,-100,-100,-386.1,360600000,9.35857E+12,0,0,360600000,9.35857E+12
4/5/22,E1VFVN30,HOSE,26100,27920,24280,25900,25710,25960,25710,25890,25900,25710,25960,25710,25890,-200,-200,-766.3,1235700000,3.19881E+13,1400000000,3.618E+13,2635700000,6.81681E+13
4/4/22,E1VFVN30,HOSE,25880,27690,24070,26100,25900,26160,25880,26030,26100,25900,26160,25880,26030,220,220,850.1,2152600000,5.60234E+13,6400000000,1.6631E+14,8552600000,2.22333E+14
4/1/22,E1VFVN30,HOSE,25300,27070,23530,25880,25310,25880,25200,25570,25880,25310,25880,25200,25570,580,580,2292.5,3624500000,9.26613E+13,7850000000,2.00241E+14,11474500000,2.92902E+14
3/31/22,E1VFVN30,HOSE,25150,26910,23390,25300,25200,25400,25200,25330,25300,25200,25400,25200,25330,150,150,596.4,1364700000,3.4574E+13,1080000000,2.73558E+13,2444700000,6.19298E+13
3/30/22,E1VFVN30,HOSE,25140,26890,23390,25150,25140,25400,25130,25320,25150,25140,25400,25130,25320,10,10,39.8,684900000,1.73439E+13,400000000,1.009E+13,1084900000,2.74339E+13
3/29/22,E1VFVN30,HOSE,25130,26880,23380,25140,25200,25200,25000,25170,25140,25200,25200,25000,25170,10,10,39.8,339300000,8.53868E+12,0,0,339300000,8.53868E+12
3/28/22,E1VFVN30,HOSE,25180,26940,23420,25130,25200,25220,24890,25010,25130,25200,25220,24890,25010,-50,-50,-198.6,838900000,2.09817E+13,0,0,838900000,2.09817E+13
3/25/22,E1VFVN30,HOSE,25150,26910,23390,25180,25200,25260,25110,25190,25180,25200,25260,25110,25190,30,30,119.3,445600000,1.1225E+13,0,0,445600000,1.1225E+13
3/24/22,E1VFVN30,HOSE,25270,27030,23510,25150,25390,25390,25150,25210,25150,25390,25390,25150,25210,-120,-120,-474.9,37100000,9.35358E+11,200000000,5.0492E+12,237100000,5.98456E+12
3/23/22,E1VFVN30,HOSE,25410,27180,23640,25270,25410,25700,25270,25410,25270,25410,25700,25270,25410,-140,-140,-551,356800000,9.06727E+12,2000000000,5.0789E+13,2356800000,5.98563E+13
3/22/22,E1VFVN30,HOSE,25280,27040,23520,25410,25290,25450,25260,25330,25410,25290,25450,25260,25330,130,130,514.2,2290300000,5.80085E+13,1800000000,4.56154E+13,4090300000,1.03624E+14
3/21/22,E1VFVN30,HOSE,25000,26750,23250,25280,25000,25280,24900,25020,25280,25000,25280,24900,25020,280,280,1120,226500000,5.66624E+12,1050000000,2.63753E+13,1276500000,3.20415E+13
3/18/22,E1VFVN30,HOSE,24860,26600,23120,25000,24910,25000,24800,24890,25000,24910,25000,24800,24890,140,140,563.2,331400000,8.24967E+12,0,0,331400000,8.24967E+12
3/17/22,E1VFVN30,HOSE,24840,26570,23110,24860,25000,25000,24710,24790,24860,25000,25000,24710,24790,20,20,80.5,364700000,9.04187E+12,0,0,364700000,9.04187E+12
3/16/22,E1VFVN30,HOSE,24700,26420,22980,24840,24710,24840,24640,24730,24840,24710,24840,24640,24730,140,140,566.8,901600000,2.22936E+13,0,0,901600000,2.22936E+13
3/15/22,E1VFVN30,HOSE,24500,26210,22790,24700,24600,24700,24450,24560,24700,24600,24700,24450,24560,200,200,816.3,763600000,1.87563E+13,0,0,763600000,1.87563E+13
3/14/22,E1VFVN30,HOSE,24990,26730,23250,24500,25000,25000,24490,24560,24500,25000,25000,24490,24560,-490,-490,-1960.8,1689900000,4.15119E+13,0,0,1689900000,4.15119E+13
3/11/22,E1VFVN30,HOSE,25150,26910,23390,24990,25140,25200,24740,24900,24990,25140,25200,24740,24900,-160,-160,-636.2,1318800000,3.28371E+13,135000000,3.36083E+12,1453800000,3.61979E+13
3/10/22,E1VFVN30,HOSE,25000,26750,23250,25150,25500,25500,25080,25160,25150,25500,25500,25080,25160,150,150,600,331200000,8.33398E+12,0,0,331200000,8.33398E+12
3/9/22,E1VFVN30,HOSE,25300,27070,23530,25000,25300,25300,24960,25030,25000,25300,25300,24960,25030,-300,-300,-1185.8,3324000000,8.31925E+13,100000000,2.5001E+12,3424000000,8.56926E+13
3/8/22,E1VFVN30,HOSE,25600,27390,23810,25300,25500,25500,25080,25180,25300,25500,25500,25080,25180,-300,-300,-1171.9,2859100000,7.2006E+13,1850000000,4.66333E+13,4709100000,1.18639E+14
3/7/22,E1VFVN30,HOSE,25700,27490,23910,25600,25500,25600,25350,25420,25600,25500,25600,25350,25420,-100,-100,-389.1,487100000,1.23836E+13,1500000000,3.8107E+13,1987100000,5.04906E+13
3/4/22,E1VFVN30,HOSE,25680,27470,23890,25700,25680,25700,25520,25610,25700,25680,25700,25520,25610,20,20,77.9,344000000,8.80868E+12,1350000000,3.45543E+13,1694000000,4.3363E+13
3/3/22,E1VFVN30,HOSE,25400,27170,23630,25680,25300,25700,25220,25290,25680,25300,25700,25220,25290,280,280,1102.4,1315200000,3.32576E+13,100000000,2.531E+12,1415200000,3.57886E+13
3/2/22,E1VFVN30,HOSE,25600,27390,23810,25400,25600,25600,25170,25230,25400,25600,25600,25170,25230,-200,-200,-781.3,1827100000,4.6098E+13,100000000,2.529E+12,1927100000,4.8627E+13
3/1/22,E1VFVN30,HOSE,25800,27600,24000,25600,25750,25750,25500,25590,25600,25750,25750,25500,25590,-200,-200,-775.2,386100000,9.87954E+12,100000000,2.5535E+12,486100000,1.2433E+13
2/28/22,E1VFVN30,HOSE,25500,27280,23720,25800,25700,25810,25430,25550,25800,25700,25810,25430,25550,300,300,1176.5,133900000,3.42093E+12,100000000,2.5445E+12,233900000,5.96543E+12
2/25/22,E1VFVN30,HOSE,25400,27170,23630,25500,25450,25800,25450,25710,25500,25450,25800,25450,25710,100,100,393.7,2660200000,6.83998E+13,0,0,2660200000,6.83998E+13
2/24/22,E1VFVN30,HOSE,25780,27580,23980,25400,25900,25900,25290,25500,25400,25900,25900,25290,25500,-380,-380,-1474,2400400000,6.12129E+13,4800000000,1.23328E+14,7200400000,1.84541E+14
2/23/22,E1VFVN30,HOSE,25900,27710,24090,25780,25900,25960,25730,25870,25780,25900,25960,25730,25870,-120,-120,-463.3,814600000,2.10704E+13,3200000000,8.27738E+13,4014600000,1.03844E+14
2/22/22,E1VFVN30,HOSE,25900,27710,24090,25900,25880,25900,25400,25620,25900,25880,25900,25400,25620,0,0,0,450500000,1.15416E+13,2000000000,5.0957E+13,2450500000,6.24986E+13
2/21/22,E1VFVN30,HOSE,25750,27550,23950,25900,25780,25900,25620,25740,25900,25780,25900,25620,25740,150,150,582.5,467100000,1.20213E+13,0,0,467100000,1.20213E+13
2/18/22,E1VFVN30,HOSE,25950,27760,24140,25750,25890,25890,25610,25690,25750,25890,25890,25610,25690,-200,-200,-770.7,587400000,1.509E+13,100000000,2.5745E+12,687400000,1.76645E+13
2/17/22,E1VFVN30,HOSE,25910,27720,24100,25950,25890,25950,25590,25730,25950,25890,25950,25590,25730,40,40,154.4,244600000,6.29313E+12,600000000,1.5504E+13,844600000,2.17971E+13
2/16/22,E1VFVN30,HOSE,25690,27480,23900,25910,26000,26000,25520,25580,25910,26000,26000,25520,25580,220,220,856.4,678500000,1.73583E+13,0,0,678500000,1.73583E+13
2/15/22,E1VFVN30,HOSE,26000,27820,24180,25690,26000,26000,25350,25570,25690,26000,26000,25350,25570,-310,-310,-1192.3,584700000,1.49524E+13,300000000,7.6575E+12,884700000,2.26099E+13
2/14/22,E1VFVN30,HOSE,26080,27900,24260,26000,26080,26080,25610,25750,26000,26080,26080,25610,25750,-80,-80,-306.7,396100000,1.01996E+13,0,0,396100000,1.01996E+13
2/11/22,E1VFVN30,HOSE,26170,28000,24340,26080,26270,26300,25000,25980,26080,26270,26300,25000,25980,-90,-90,-343.9,403800000,1.04916E+13,0,0,403800000,1.04916E+13
2/10/22,E1VFVN30,HOSE,26300,28140,24460,26170,26360,26360,25930,26030,26170,26360,26360,25930,26030,-130,-130,-494.3,393200000,1.02339E+13,800000000,2.0824E+13,1193200000,3.10579E+13
2/9/22,E1VFVN30,HOSE,26100,27920,24280,26300,26110,26300,26100,26190,26300,26110,26300,26100,26190,200,200,766.3,616000000,1.61334E+13,4600000000,1.20931E+14,5216000000,1.37064E+14
2/8/22,E1VFVN30,HOSE,25910,27720,24100,26100,25990,26100,25800,25930,26100,25990,26100,25800,25930,190,190,733.3,1152900000,2.98951E+13,5140000000,1.33385E+14,6292900000,1.6328E+14
2/7/22,E1VFVN30,HOSE,25740,27540,23940,25910,25780,26080,25780,26010,25910,25780,26080,25780,26010,170,170,660.5,1322600000,3.44006E+13,1500000000,3.885E+13,2822600000,7.32506E+13
1/28/22,E1VFVN30,HOSE,25580,27370,23790,25740,25720,25750,25590,25660,25740,25720,25750,25590,25660,160,160,625.5,1470700000,3.77414E+13,300000000,7.7295E+12,1770700000,4.54709E+13
1/27/22,E1VFVN30,HOSE,25500,27280,23720,25580,25680,25680,25340,25500,25580,25680,25680,25340,25500,80,80,313.7,2579400000,6.57834E+13,300000000,7.695E+12,2879400000,7.34784E+13
1/26/22,E1VFVN30,HOSE,25180,26940,23420,25500,25300,25680,25300,25540,25500,25300,25680,25300,25540,320,320,1270.8,2204600000,5.63075E+13,600000000,1.53654E+13,2804600000,7.16729E+13
1/25/22,E1VFVN30,HOSE,24970,26710,23230,25180,24970,25260,24630,24980,25180,24970,25260,24630,24980,210,210,841,3517500000,8.78567E+13,0,0,3517500000,8.78567E+13
1/24/22,E1VFVN30,HOSE,25110,26860,23360,24970,25280,25280,24630,25050,24970,25280,25280,24630,25050,-140,-140,-557.5,992800000,2.48732E+13,0,0,992800000,2.48732E+13
1/21/22,E1VFVN30,HOSE,24950,26690,23210,25110,25200,25350,25090,25180,25110,25200,25350,25090,25180,160,160,641.3,299600000,7.54483E+12,0,0,299600000,7.54483E+12
1/20/22,E1VFVN30,HOSE,25200,26960,23440,24950,25200,25210,24810,25020,24950,25200,25210,24810,25020,-250,-250,-992.1,455200000,1.1388E+13,500000000,1.255E+13,955200000,2.3938E+13
1/19/22,E1VFVN30,HOSE,25290,27060,23520,25200,25290,25500,24880,25000,25200,25290,25500,24880,25000,-90,-90,-355.9,746300000,1.86584E+13,3900000000,9.7131E+13,4646300000,1.15789E+14
1/18/22,E1VFVN30,HOSE,25000,26750,23250,25290,25000,25300,24700,24890,25290,25000,25300,24700,24890,290,290,1160,1140000000,2.83732E+13,2200000000,5.46695E+13,3340000000,8.30427E+13
1/17/22,E1VFVN30,HOSE,25650,27440,23860,25000,25700,25700,25000,25280,25000,25700,25700,25000,25280,-650,-650,-2534.1,727000000,1.83754E+13,300000000,7.551E+12,1027000000,2.59264E+13
1/14/22,E1VFVN30,HOSE,25810,27610,24010,25650,25670,25700,25490,25590,25650,25670,25700,25490,25590,-160,-160,-619.9,256600000,6.56557E+12,0,0,256600000,6.56557E+12
1/13/22,E1VFVN30,HOSE,25210,26970,23450,25810,25860,25990,25530,25740,25810,25860,25990,25530,25740,600,600,2380,1560200000,4.01589E+13,100000000,2.516E+12,1660200000,4.26749E+13
1/12/22,E1VFVN30,HOSE,25400,27170,23630,25210,25400,25520,24990,25250,25210,25400,25520,24990,25250,-190,-190,-748,2134800000,5.3899E+13,650000000,1.6389E+13,2784800000,7.0288E+13
1/11/22,E1VFVN30,HOSE,25580,27370,23790,25400,25450,25610,25130,25400,25400,25450,25610,25130,25400,-180,-180,-703.7,1546000000,3.92679E+13,400000000,1.0092E+13,1946000000,4.93599E+13
1/10/22,E1VFVN30,HOSE,25850,27650,24050,25580,25850,25850,25500,25690,25580,25850,25850,25500,25690,-270,-270,-1044.5,1313400000,3.37405E+13,140000000,3.584E+12,1453400000,3.73245E+13
1/7/22,E1VFVN30,HOSE,25820,27620,24020,25850,25900,26050,25400,25790,25850,25900,26050,25400,25790,30,30,116.2,1417700000,3.65591E+13,0,0,1417700000,3.65591E+13
1/6/22,E1VFVN30,HOSE,25990,27800,24180,25820,25980,26090,25820,25980,25820,25980,26090,25820,25980,-170,-170,-654.1,1612600000,4.18906E+13,400000000,1.04015E+13,2012600000,5.22921E+13
1/5/22,E1VFVN30,HOSE,26200,28030,24370,25990,26200,26300,25980,26120,25990,26200,26300,25980,26120,-210,-210,-801.5,1500400000,3.91871E+13,0,0,1500400000,3.91871E+13
1/4/22,E1VFVN30,HOSE,25830,27630,24030,26200,25850,26240,25850,26100,26200,25850,26240,25850,26100,370,370,1432.4,959300000,2.5041E+13,1630000000,4.075E+13,2589300000,6.5791E+13